,budget,genre,gross,name,runtime,score,votes,Profit
0,8000000,Adventure,52287414,Stand by Me,89,8.1,299174,44287414
1,6000000,Comedy,70136369,Ferris Bueller's Day Off,103,7.8,264740,64136369
2,15000000,Action,179800601,Top Gun,110,6.9,236909,164800601
3,18500000,Action,85160248,Aliens,137,8.4,540152,66660248
4,9000000,Adventure,18564613,Flight of the Navigator,90,6.9,36636,9564613
5,6000000,Drama,138530565,Platoon,120,8.1,317585,132530565
6,25000000,Adventure,12729917,Labyrinth,101,7.4,102879,-12270083
7,6000000,Drama,8551228,Blue Velvet,120,7.8,146768,2551228
8,9000000,Comedy,40471663,Pretty in Pink,96,6.8,60565,31471663
9,15000000,Drama,40456565,The Fly,96,7.5,129698,25456565
10,8800000,Adventure,174635000,Crocodile Dundee,97,6.5,79465,165835000
11,16000000,Action,5900000,Highlander,116,7.2,104860,-10100000
12,6000000,Comedy,8200000,Lucas,100,6.8,12228,2200000
13,25000000,Action,11100000,Big Trouble in Little China,99,7.3,101678,-13900000
14,15000000,Crime,8620929,Manhunter,120,7.2,54000,-6379071
15,17000000,Drama,6734844,9½ Weeks,117,5.9,31798,-10265156
16,10000000,Action,7433663,Maximum Overdrive,98,5.4,24881,-2566337
17,25000000,Comedy,38747385,Little Shop of Horrors,94,6.9,53327,13747385
18,2700000,Action,3500000,The Wraith,93,5.9,11635,800000
19,35000000,Action,16295774,Howard the Duck,110,4.6,36020,-18704226
20,2000000,Action,13167232,Critters,82,6.0,25517,11167232
21,11000000,Comedy,91258000,Back to School,96,6.6,23120,80258000
22,4700000,Comedy,8025872,The Texas Chainsaw Massacre 2,89,5.6,21253,3325872
23,15000000,Action,42724017,Heartbreak Ridge,130,6.8,32954,27724017
24,25000000,Adventure,109713132,Star Trek IV: The Voyage Home,119,7.3,66366,84713132
25,0,Comedy,40697761,Short Circuit,98,6.6,47068,40697761
26,0,Crime,7153487,The Name of the Rose,130,7.8,86991,7153487
27,0,Action,24159872,Iron Eagle,117,5.3,11304,24159872
28,25000000,Action,79817937,The Golden Child,94,5.9,42997,54817937
29,1900000,Crime,4600000,River's Edge,99,7.1,12862,2700000
30,25000000,Comedy,39246734,¡Three Amigos!,104,6.4,57406,14246734
31,25000000,Action,49042224,Cobra,87,5.7,54851,24042224
32,0,Drama,2003822,Betty Blue,120,7.4,14562,2003822
33,24500000,Adventure,17218023,The Mission,125,7.5,47497,-7281977
34,13800000,Drama,52293982,The Color of Money,119,7.0,62495,38493982
35,0,Action,115103979,The Karate Kid Part II,113,5.9,58370,115103979
36,0,Drama,7177431,The Boy Who Could Fly,114,6.5,4623,7177431
37,6000000,Thriller,5844868,The Hitcher,97,7.3,36191,-155132
38,10000000,Comedy,37499651,The Money Pit,91,6.3,41278,27499651
39,3000000,Horror,19472057,Jason Lives: Friday the 13th Part VI,86,5.9,28310,16472057
40,25000000,Adventure,14302779,The Mosquito Coast,117,6.6,23076,-10697221
41,0,Animation,47483002,An American Tail,80,6.9,41004,47483002
42,4000000,Biography,2826523,Sid and Nancy,112,7.1,25032,-1173477
43,10000000,Action,4711220,King Kong Lives,105,3.8,4401,-5288780
44,4500000,Horror,1261000,From Beyond,86,6.7,16636,-3239000
45,18000000,Comedy,41382841,Peggy Sue Got Married,103,6.3,28529,23382841
46,19000000,Horror,40996665,Poltergeist II: The Other Side,91,5.7,20669,21996665
47,1100000,Comedy,5450815,Troll,82,4.3,7569,4350815
48,0,Action,38500726,Running Scared,107,6.5,9344,38500726
49,0,Comedy,26285544,Wildcats,106,5.9,10239,26285544
50,111000,Biography,609939,Henry: Portrait of a Serial Killer,83,7.0,25367,498939
51,18000000,Adventure,9697739,SpaceCamp,107,5.6,11484,-8302261
52,6400000,Comedy,40084041,Hannah and Her Sisters,107,8.0,56988,33684041
53,14000000,Animation,38600000,The Great Mouse Detective,74,7.2,36539,24600000
54,8500000,Action,16209459,Raw Deal,106,5.5,24851,7709459
55,6000000,Animation,5849647,The Transformers: The Movie,84,7.3,33609,-150353
56,0,Drama,2015882,Rad,91,7.2,4039,2015882
57,5000000,Comedy,591366,Night of the Creeps,88,6.8,16077,-4408634
58,12000000,Horror,4884663,Invaders from Mars,100,5.5,5878,-7115337
59,0,Drama,5839031,Crossroads,99,7.1,11415,5839031
60,6000000,Drama,28607524,Hoosiers,114,7.6,36604,22607524
61,0,Drama,300653,Sacrifice,149,8.1,16571,300653
62,6500000,Crime,2347000,At Close Range,111,7.0,11607,-4153000
63,0,Drama,15448384,Youngblood,110,6.1,10412,15448384
64,0,Action,4662137,"No Retreat, No Surrender",85,5.6,12803,4662137
65,0,Horror,14481606,Psicosis III,93,5.3,10022,14481606
66,20000000,Comedy,25314289,Heartburn,108,6.1,7570,5314289
67,15000000,Adventure,1953732,The Clan of the Cave Bear,98,5.3,5340,-13046268
68,12000000,Action,17768900,The Delta Force,125,5.6,15819,5768900
69,0,Drama,8988731,Deadly Friend,91,5.5,5419,8988731
70,0,Comedy,38702310,About Last Night...,113,6.2,12307,38702310
71,0,Comedy,27820000,Soul Man,104,5.2,6440,27820000
72,0,Comedy,13431806,One Crazy Summer,93,6.4,11581,13431806
73,0,Comedy,6797218,Trick or Treat,98,5.8,4585,6797218
74,18000000,Comedy,36611610,Gung Ho,112,6.2,9965,18611610
75,0,Crime,25147055,The Morning After,103,6.0,4943,25147055
76,0,Comedy,43579163,Police Academy 3: Back in Training,83,5.2,35443,43579163
77,175000,Comedy,7137502,She's Gotta Have It,84,6.6,5257,6962502
78,0,Comedy,71624879,Ruthless People,93,6.9,22554,71624879
79,8700000,Action,4865912,Band of the Hand,109,6.3,2297,-3834088
80,0,Crime,5186646,52 Pick-Up,110,6.4,3866,5186646
81,0,Drama,31853080,Children of a Lesser God,119,7.2,12538,31853080
82,12000000,Action,15945534,Armed and Dangerous,88,5.6,9040,3945534
83,1100000,Comedy,1436000,Down by Law,107,7.8,39456,336000
84,10000000,Action,20603715,F/X,109,6.7,14502,10603715
85,0,Adventure,13245219,The Adventures of Milo and Otis,90,7.1,9178,13245219
86,0,Comedy,8362969,Something Wild,114,6.9,13186,8362969
87,18000000,Sci-Fi,3900000,The Manhattan Project,117,6.1,4666,-14100000
88,5000000,Horror,12947763,April Fool's Day,89,6.2,11458,7947763
89,25000000,Action,1579260,Solarbabies,94,4.8,3397,-23420740
90,0,Comedy,17685307,The Big Easy,102,6.6,10022,17685307
91,0,Comedy,25587804,Jumpin' Jack Flash,105,5.8,15703,25587804
92,40000000,Adventure,1641825,Piratas,121,6.1,6596,-38358175
93,0,Animation,5274,When the Wind Blows,80,7.8,7900,5274
94,10000000,Comedy,21458229,Tough Guys,104,6.2,5584,11458229
95,0,Drama,206952,Matador,110,7.0,8959,206952
96,0,Action,6637565,Black Moon Rising,100,5.4,4045,6637565
97,12000000,Comedy,7790931,The Best of Times,104,5.9,5523,-4209069
98,2000000,Horror,7369373,Witchboard,98,5.7,4744,5369373
99,14000000,Comedy,62134225,Down and Out in Beverly Hills,103,6.1,13569,48134225
100,8500000,Biography,277646,Lady Jane,136,7.2,5364,-8222354
101,0,Crime,7634909,Quicksilver,105,5.6,3720,7634909
102,0,Animation,5958456,My Little Pony: The Movie,86,6.0,2125,5958456
103,0,Horror,916172,Gothic,87,5.7,5843,916172
104,18000000,Action,1305114,8 Million Ways to Die,115,5.7,3607,-16694886
105,0,Crime,12303904,No Mercy,106,5.7,5564,12303904
106,0,Comedy,8033397,Haunted Honeymoon,82,5.6,5549,8033397
107,0,Comedy,320256,TerrorVision,83,5.7,4620,320256
108,0,Action,3751699,Allan Quatermain and the Lost City of Gold,99,4.4,7491,3751699
109,0,Crime,5794184,Mona Lisa,104,7.4,10747,5794184
110,0,Comedy,32324557,Nothing in Common,118,5.9,5345,32324557
111,8000000,Action,11834302,Firewalker,104,5.0,4752,3834302
112,0,Adventure,483460,Castaway,117,6.0,2649,483460
113,3300000,Comedy,4941117,Vamp,93,5.9,3909,1641117
114,0,Biography,3151,Caravaggio,93,6.7,4072,3151
115,0,Crime,21483,Mauvais Sang,116,7.3,4922,21483
116,0,Drama,4636169,Fire with Fire,103,6.6,1264,4636169
117,15000000,Comedy,12308521,Club Paradise,96,4.9,5049,-2691479
118,40000000,Comedy,49851591,Legal Eagles,116,5.9,8374,9851591
119,0,Comedy,1476356,Clockwise,96,6.6,9689,1476356
120,0,Drama,13418091,Extremities,89,6.3,2705,13418091
121,13000000,Comedy,8475466,Wise Guys,100,5.6,4573,-4524534
122,0,Drama,2444076,The Men's Club,101,4.5,680,2444076
123,0,Drama,4940939,Jean de Florette,120,8.1,20914,4940939
124,0,Drama,2510433,Reform School Girls,94,5.2,1717,2510433
125,0,Drama,3940542,Manon of the Spring,113,8.0,17849,3940542
126,17000000,Adventure,2315683,Shanghai Surprise,97,3.1,4339,-14684317
127,16000000,Drama,3800000,Power,111,5.7,2287,-12200000
128,0,Comedy,604849,Modern Girls,84,5.9,1023,604849
129,20000000,Comedy,22905500,Crimes of the Heart,105,6.4,3079,2905500
130,0,Horror,2278264,Nomads,91,5.5,3006,2278264
131,0,Action,4601256,Eliminators,96,4.5,1422,4601256
132,0,Comedy,2147228,Meatballs III: Summer Job,96,3.3,2003,2147228
133,6000000,Action,9947631,Murphy's Law,100,5.9,3561,3947631
134,0,Musical,2545142,True Stories,90,7.0,3885,2545142
135,0,Comedy,10090429,Under the Cherry Moon,98,4.9,2549,10090429
136,0,Drama,278623,Every Time We Say Goodbye,95,5.9,1834,278623
137,0,Drama,930211,Absolute Beginners,108,5.6,2659,930211
138,0,Drama,3272600,'Round Midnight,133,7.4,4028,3272600
139,4000000,Action,4679650,Avenging Force,104,5.9,1808,679650
140,0,Action,2995527,Bullies,96,5.4,340,2995527
141,0,Adventure,112132,Biggles: Adventures in Time,88,5.8,2243,112132
142,0,Drama,4845724,American Anthem,102,4.0,1284,4845724
143,0,Action,5099316,Out of Bounds,93,5.4,1016,5099316
144,0,Comedy,4781448,My Chauffeur,97,5.6,1426,4781448
145,18000000,Comedy,11957943,Brighton Beach Memoirs,108,6.9,2720,-6042057
146,0,Drama,37455,Summer,98,7.8,4612,37455
147,0,Drama,3136701,The Naked Cage,97,5.5,327,3136701
148,0,Horror,1720450,Link,100,5.9,2080,1720450
149,0,Thriller,1131399,Half Moon Street,90,5.4,2157,1131399
150,0,Drama,441863,"'night, Mother",96,7.6,1840,441863
151,0,Action,6029824,A Fine Mess,90,4.5,1164,6029824
152,0,Comedy,78068,Hardbodies 2,88,2.9,895,78068
153,0,Drama,203781,The Assault,155,7.3,2694,203781
154,0,Comedy,277405,Willy/Milly,86,5.7,323,277405
155,0,Drama,239073,The Ladies Club,85,5.3,154,239073
156,0,Action,140980,Let's Get Harry,102,5.2,978,140980
157,25000000,Adventure,4007250,Tai-Pan,127,5.5,1340,-20992750
158,0,Comedy,2750741,Deadtime Stories,93,4.6,973,2750741
159,17000000,Action,2793214,Heat,101,5.5,1358,-14206786
160,0,Comedy,1254040,Touch and Go,101,5.8,684,1254040
161,0,Biography,275000,The Boy in Blue,100,5.4,907,275000
162,0,Comedy,14205021,Sweet Liberty,106,5.7,2300,14205021
163,0,Comedy,681337,Killer Party,91,4.7,1265,681337
164,0,Drama,537681,Parting Glances,90,7.8,2330,537681
165,0,Animation,8540346,Care Bears Movie II: A New Generation,76,5.3,1760,8540346
166,14000000,Biography,18034150,"Jo Jo Dancer, Your Life Is Calling",97,6.3,1288,4034150
167,0,Action,1943751,Jake Speed,100,5.3,632,1943751
168,3401376,Action,3388020,Born American,97,4.3,1509,-13356
169,10000000,Action,6947787,Blue City,83,4.4,792,-3052213
170,0,Comedy,544472,Malcolm,90,7.2,1623,544472
171,0,Comedy,2669366,Playing for Keeps,102,4.1,515,2669366
172,0,Drama,8736,Duet for One,107,7.0,699,8736
173,0,Comedy,563358,Nobody's Fool,107,5.5,652,563358
174,0,Comedy,444746,The Whoopee Boys,88,6.2,639,444746
175,0,Comedy,4079895,That's Life!,102,6.1,1032,4079895
176,0,Comedy,14926,Body Slam,89,5.3,795,14926
177,0,Thriller,750000,Defense of the Realm,96,6.6,1625,750000
178,0,Drama,725000,Man Facing Southeast,105,7.8,2991,725000
179,0,Comedy,1902706,The Decline of the American Empire,101,7.3,6622,1902706
180,0,Drama,4743287,Violets Are Blue...,88,5.7,553,4743287
181,0,Thriller,1500000,The Whistle Blower,100,6.2,1672,1500000
182,2000000,Drama,1301121,Native Son,111,5.9,448,-698879
183,0,Drama,416393,Desert Bloom,105,6.6,821,416393
184,0,Drama,1777378,Working Girls,93,6.5,604,1777378
185,0,Comedy,925952,Ménage,84,7.0,2022,925952
186,0,Biography,583800,Oviri,100,6.2,275,583800
187,0,Action,181410,In the Shadow of Kilimanjaro,100,5.1,310,181410
188,0,Drama,432266,Kangaroo,108,6.7,156,432266
189,0,Action,2390525,Dangerously Close,95,6.6,935,2390525
190,0,Family,781727,Nutcracker,100,7.2,578,781727
191,0,Comedy,837623,Ginger and Fred,125,7.3,3859,837623
192,0,Crime,502237,Dream Lover,104,5.1,405,502237
193,0,Drama,6408791,Just Between Friends,110,5.9,629,6408791
194,0,Action,145975,Thunder Run,90,5.1,218,145975
195,0,Comedy,1096843,The Longshot,89,5.4,457,1096843
196,0,Comedy,4842778,Off Beat,92,5.0,748,4842778
197,0,Drama,2520664,Streets of Gold,95,6.0,505,2520664
198,0,Action,351623,Weekend Warriors,100,4.4,237,351623
199,18000000,Action,2295500,Sky Bandits,100,4.6,183,-15704500
200,1500000,Action,1368912,Armed Response,86,4.9,489,-131088
201,0,Drama,189042,Otello,100,7.2,424,189042
202,0,Drama,440438,On the Edge,95,7.1,171,440438
203,0,Action,63860,Low Blow,100,3.5,256,63860
204,0,Drama,1444618,Belizaire the Cajun,103,6.4,391,1444618
205,0,Drama,227510,A Man and a Woman: 20 Years Later,112,5.8,496,227510
206,0,Action,1900000,Quiet Cool,100,5.7,542,1900000
207,0,Action,2497233,Behind Enemy Lines,90,4.9,368,2497233
208,0,Action,193153,Wired to Kill,86,4.2,163,193153
209,0,Drama,149440,The Fringe Dwellers,98,6.7,305,149440
210,0,Crime,164187,Scene of the Crime,90,6.9,565,164187
211,0,Animation,1338264,GoBots: Battle of the Rock Lords,75,5.8,397,1338264
212,0,Comedy,267249,The Gospel According to Vic,92,6.1,227,267249
213,0,Action,601451,Knights of the City,87,4.8,103,601451
214,0,Comedy,18209,Saving Grace,112,7.0,467,18209
215,0,Action,492367,Jackals,97,5.3,139,492367
216,0,Comedy,22123,Detective School Dropouts,92,5.8,220,22123
217,0,Adventure,676166,Where the River Runs Black,100,6.6,351,676166
218,0,Family,2193642,Heathcliff: The Movie,73,5.3,187,2193642
219,0,Comedy,32279,One More Saturday Night,95,5.7,211,32279
220,16000000,Adventure,30857814,The Princess Bride,98,8.1,320953,14857814
221,1000000,Horror,14564027,Hellraiser,94,7.0,83209,13564027
222,30000000,Drama,46357676,Full Metal Jacket,116,8.3,537826,16357676
223,6000000,Drama,63952836,Dirty Dancing,100,6.9,155978,57952836
224,0,Comedy,32222567,The Lost Boys,97,7.3,100376,32222567
225,15000000,Action,59735548,Predator,107,7.8,313213,44735548
226,27000000,Action,38122105,The Running Man,101,6.6,120345,11122105
227,22700000,Adventure,38119483,Spaceballs,96,7.1,146748,15419483
228,13000000,Action,53424681,RoboCop,102,7.5,196245,40424681
229,15000000,Action,65207127,Lethal Weapon,110,7.6,204328,50207127
230,25000000,Crime,76270454,The Untouchables,119,7.9,234254,51270454
231,3600000,Comedy,5923044,Evil Dead II,84,7.8,123325,2323044
232,22000000,Action,17336370,Masters of the Universe,106,5.4,30370,-4663630
233,12000000,Action,3769990,The Monster Squad,82,7.2,21420,-8230010
234,14000000,Drama,156645693,Fatal Attraction,119,6.9,60383,142645693
235,30000000,Action,51185897,The Living Daylights,130,6.7,74272,21185897
236,15000000,Crime,43848100,Wall Street,126,7.4,126195,28848100
237,35000000,Drama,22238696,Empire of the Sun,153,7.8,96566,-12761304
238,0,Comedy,31623833,Can't Buy Me Love,94,6.7,26348,31623833
239,22000000,Comedy,63766510,The Witches of Eastwick,118,6.5,51642,41766510
240,0,Comedy,35658098,Summer School,97,6.5,14038,35658098
241,4500000,Action,44793222,A Nightmare on Elm Street 3: Dream Warriors,96,6.6,55414,40293222
242,0,Action,34368475,Adventures in Babysitting,102,6.9,30850,34368475
243,0,Action,13839404,Hamburger Hill,110,6.7,20159,13839404
244,23000000,Adventure,20763013,Jaws: The Revenge,89,2.9,33419,-2236987
245,25000000,Action,16057580,Over the Top,93,5.7,40916,-8942420
246,30000000,Comedy,49530280,"Planes, Trains & Automobiles",93,7.6,98897,19530280
247,6000000,Comedy,22847564,Raising Arizona,94,7.4,107669,16847564
248,17000000,Horror,17185632,Angel Heart,113,7.3,67453,185632
249,0,Drama,18553948,Some Kind of Wonderful,95,7.1,21931,18553948
250,6000000,Comedy,42721196,Mannequin,90,5.8,24626,36721196
251,0,Comedy,26713187,Overboard,106,6.8,40429,26713187
252,27000000,Action,25893810,Innerspace,120,6.8,45172,-1106190
253,15000000,Comedy,80640528,Moonstruck,102,7.1,38600,65640528
254,28000000,Action,153665000,Beverly Hills Cop II,100,6.5,90969,125665000
255,0,Comedy,29760613,Harry and the Hendersons,110,5.9,26157,29760613
256,23000000,Biography,43984230,The Last Emperor,163,7.8,76408,20984230
257,13000000,Biography,123922370,"Good Morning, Vietnam",121,7.3,106924,110922370
258,2600000,Drama,3130592,Maurice,140,7.7,11837,530592
259,11000000,Comedy,167780960,3 Men and a Baby,102,5.9,39544,156780960
260,3000000,Horror,14182492,Prince of Darkness,102,6.7,28064,11182492
261,6500000,Biography,54215416,La Bamba,108,6.8,22839,47715416
262,5000000,Action,3369307,Near Dark,94,7.0,27485,-1630693
263,0,Drama,3210139,Wings of Desire,128,8.1,51522,3210139
264,0,Crime,12396383,Less Than Zero,98,6.4,15500,12396383
265,15000000,Action,35509515,No Way Out,114,7.1,28684,20509515
266,0,Comedy,32945797,*batteries not included,106,6.6,25330,32945797
267,0,Comedy,26712476,Baby Boom,110,6.1,11414,26712476
268,0,Comedy,1544889,Withnail & I,107,7.8,33285,1544889
269,0,Drama,15151736,Flowers in the Attic,93,5.7,7993,15151736
270,20000000,Comedy,51249404,Broadcast News,133,7.2,22802,31249404
271,2500000,Fantasy,13539458,Túnel al infierno,85,6.0,11435,11039458
272,17000000,Action,15681020,Superman IV: The Quest for Peace,90,3.6,35866,-1318980
273,3500000,Comedy,14000000,Creepshow 2,92,6.0,17500,10500000
274,3000000,Comedy,7888703,Teen Wolf Too,95,3.2,8905,4888703
275,12000000,Comedy,40050884,Roxanne,107,6.6,34794,28050884
276,12000000,Comedy,66995879,The Secret of My Succe$s,111,6.5,24685,54995879
277,20000000,Comedy,57387516,Dragnet,106,5.9,27387,37387516
278,0,Comedy,124167,"Rita, Sue and Bob Too",93,6.4,2747,124167
279,18000000,Comedy,39321715,Blind Date,95,5.9,17903,21321715
280,0,Comedy,7800000,House II: The Second Story,88,5.4,8302,7800000
281,0,Comedy,28061343,Police Academy 4: Citizens on Patrol,88,4.8,33955,28061343
282,1000000,Adventure,1576615,The Garbage Pail Kids Movie,100,2.7,6348,576615
283,14000000,Comedy,57915972,Throw Momma from the Train,88,6.2,28550,43915972
284,0,Horror,2488740,The Stepfather,89,6.8,9959,2488740
285,0,Action,9747988,The Hidden,96,7.0,13878,9747988
286,0,Comedy,548696,Amazon Women on the Moon,85,6.2,8755,548696
287,3000000,Comedy,3221568,Barfly,100,7.3,15647,221568
288,6000000,Comedy,3685862,Three O'Clock High,97,7.2,8970,-2314138
289,0,Comedy,4398938,Babette's Feast,102,7.8,14838,4398938
290,0,Crime,18753438,The Believers,114,6.1,4900,18753438
291,15000000,Comedy,13290368,The Pick-up Artist,81,5.2,5348,-1709632
292,16000000,Comedy,14792779,Radio Days,88,7.6,26467,-1207221
293,0,Comedy,1028679,Aria,90,5.8,2243,1028679
294,3000000,Comedy,23509382,Ernest Goes to Camp,92,5.5,9526,20509382
295,0,Drama,4542825,Au Revoir les Enfants,104,8.0,25969,4542825
296,17000000,Crime,10278549,Someone to Watch Over Me,106,6.1,7854,-6721451
297,0,Comedy,7305209,Who's That Girl,92,4.7,8125,7305209
298,29000000,Biography,5899797,Cry Freedom,157,7.5,10692,-23100203
299,6000000,Thriller,12423831,The Fourth Protocol,119,6.5,7532,6423831
300,27000000,Drama,7393346,Ironweed,143,6.8,6874,-19606654
301,0,Crime,25205460,Black Widow,102,6.3,7132,25205460
302,0,Action,65673233,Stakeout,117,6.6,20039,65673233
303,0,Comedy,34377585,Like Father Like Son,96,5.1,4817,34377585
304,0,Comedy,3587303,Bagdad Cafe,95,7.5,10255,3587303
305,0,Drama,769119,Shy People,100,6.9,940,769119
306,0,Comedy,30063289,Revenge of the Nerds II: Nerds in Paradise,88,4.9,11444,30063289
307,0,Horror,2683519,Prom Night II,97,5.6,3440,2683519
308,5000000,Action,6880310,Death Wish 4: The Crackdown,99,5.3,6770,1880310
309,18000000,Comedy,18532286,Project X,108,6.1,8879,532286
310,0,Action,3832228,North Shore,96,6.5,1903,3832228
311,0,Action,519596,Man on Fire,87,5.9,1340,519596
312,4000000,Fantasy,800000,The Barbarians,87,4.9,2538,-3200000
313,55000000,Action,14375181,Ishtar,107,4.2,9094,-40624819
314,100000,Comedy,5228617,Hollywood Shuffle,78,7.0,3009,5128617
315,0,Comedy,1749956,Hunk,102,4.6,1042,1749956
316,0,Crime,2585639,House of Games,102,7.3,17508,2585639
317,0,Crime,2877571,No Man's Land,100,6.1,3297,2877571
318,0,Sci-Fi,1930001,The Curse,92,4.9,1762,1930001
319,0,Crime,18782400,Suspect,121,6.6,7506,18782400
320,0,Action,19734940,The Principal,109,6.2,7311,19734940
321,0,Comedy,10021120,Hope and Glory,113,7.4,10291,10021120
322,0,Comedy,52864741,Outrageous Fortune,99,6.1,6123,52864741
323,22000000,Action,11307844,Extreme Prejudice,96,6.6,4924,-10692156
324,350000,Action,4000000,American Ninja 2: The Confrontation,90,4.8,6565,3650000
325,4000000,Drama,1680358,Matewan,135,7.9,6198,-2319642
326,0,Drama,1539000,Three for the Road,88,5.3,813,1539000
327,24000000,Action,4916871,Leonard Part 6,85,2.2,7387,-19083129
328,5000000,Crime,1119112,Street Smart,97,6.4,2096,-3880888
329,0,Biography,1654743,Prick Up Your Ears,105,7.4,4799,1654743
330,9000000,Action,5406879,The Sicilian,115,5.3,3889,-3593121
331,0,Comedy,17355263,Born in East L.A.,85,5.9,4648,17355263
332,0,Drama,10489617,Light of Day,107,5.5,2101,10489617
333,0,Drama,2053931,Pelle the Conqueror,157,7.9,8321,2053931
334,0,Comedy,1189709,Return to Horror High,95,4.2,2337,1189709
335,0,Comedy,13110903,Back to the Beach,92,5.8,2332,13110903
336,0,Horror,1149470,Nightflyers,89,4.0,796,1149470
337,0,Action,12046526,Fatal Beauty,104,5.3,2652,12046526
338,0,Adventure,300859,White Water Summer,90,6.2,4353,300859
339,0,Drama,1338198,The Whales of August,90,7.6,3416,1338198
340,7000000,Comedy,7019441,Hiding Out,98,6.4,2584,19441
341,0,Comedy,174380,My Best Friend Is a Vampire,89,6.1,2690,174380
342,10000000,Action,3060858,Malone,92,5.6,1959,-6939142
343,0,Comedy,4215859,Hot Pursuit,93,5.8,2768,4215859
344,0,Action,873903,Real Men,85,6.2,3077,873903
345,6000000,Action,1432687,A Prayer for the Dying,107,6.4,3731,-4567313
346,0,Drama,5262047,Gardens of Stone,111,6.4,4273,5262047
347,0,Action,7555000,Wanted: Dead or Alive,106,5.9,3328,7555000
348,0,Animation,6804312,The Chipmunk Adventure,100,7.2,4383,6804312
349,0,Horror,2407024,The Kindred,91,5.5,1211,2407024
350,0,Comedy,4572845,Made in Heaven,100,6.5,2691,4572845
351,0,Crime,5715174,Wisdom,109,5.7,2659,5715174
352,5300000,Crime,3107551,White Mischief,107,6.3,2171,-2192449
353,10000000,Drama,486434,September,83,6.7,7620,-9513566
354,0,Drama,4370078,The Dead,83,7.4,5933,4370078
355,3520000,Action,562187,Steel Dawn,100,5.0,3860,-2957813
356,1300000,Crime,354704,Prison,102,5.9,3019,-945296
357,25000000,Drama,30950002,Nuts,116,6.7,4996,5950002
358,11000000,Comedy,25411386,Tin Men,112,6.5,6960,14411386
359,0,Drama,760000,The Hanoi Hilton,125,6.0,763,760000
360,7500000,Drama,796368,Rampage,97,6.3,1625,-6703632
361,0,Drama,1733017,The Big Town,109,5.9,1483,1733017
362,0,Comedy,3283832,Wish You Were Here,88,6.8,2212,3283832
363,0,Comedy,2700000,The Allnighter,108,4.0,904,2700000
364,0,Drama,287725,The Belly of an Architect,119,7.0,4517,287725
365,0,Action,4278150,Best Seller,95,6.5,3752,4278150
366,0,Drama,700000,Siesta,100,5.6,1844,700000
367,0,Drama,316199,Promised Land,102,5.7,1052,316199
368,0,Crime,12640385,The Bedroom Window,112,6.4,3650,12640385
369,0,Comedy,2201428,Dark Eyes,117,7.6,2421,2201428
370,3000000,Fantasy,9868521,Maid to Order,93,5.5,2786,6868521
371,0,Drama,225358,Square Dance,112,6.1,730,225358
372,1000000,Action,210200,Straight to Hell,100,5.8,1924,-789800
373,0,Comedy,16337355,Burglar,103,5.0,3453,16337355
374,0,Comedy,999382,In the Mood,98,6.1,778,999382
375,0,Biography,1083486,84 Charing Cross Road,100,7.5,6285,1083486
376,100000,Horror,154323,"Silent Night, Deadly Night 2",88,3.5,4329,54323
377,0,Crime,969205,Five Corners,90,6.3,2584,969205
378,8000000,Comedy,1988962,Date with an Angel,105,5.8,2163,-6011038
379,5800000,Biography,257043,Walker,94,6.6,2684,-5542957
380,0,Adventure,626724,Deadly Illusion,87,4.7,233,626724
381,0,Mystery,406881,Slam Dance,92,5.3,1129,406881
382,19000000,Action,2228951,The Squeeze,101,4.6,770,-16771049
383,0,Comedy,1744164,Personal Services,105,6.4,1031,1744164
384,5000000,Action,6075793,Assassination,88,5.1,2255,1075793
385,75000,Horror,13133,Creepozoids,72,3.5,1447,-61867
386,0,Crime,1262091,China Girl,90,6.1,1214,1262091
387,12000000,Comedy,5669831,Nadine,83,5.5,3267,-6330169
388,0,Drama,2413427,Dead of Winter,100,6.3,2694,2413427
389,0,Adventure,108154,"No Retreat, No Surrender 2",104,5.1,1209,108154
390,0,Drama,895904,The Glass Menagerie,134,7.2,1699,895904
391,0,Horror,228789,Anguish,86,6.7,2611,228789
392,0,Drama,443524,A Month in the Country,96,7.2,1038,443524
393,1100000,Action,1355728,From a Whisper to a Scream,99,6.0,1489,255728
394,0,Comedy,20419446,Hello Again,96,5.1,2493,20419446
395,0,Drama,1025228,Little Dorrit,357,7.5,886,1025228
396,0,Comedy,460608,Walk Like a Man,86,4.6,1174,460608
397,5000000,Comedy,858250,Tough Guys Don't Dance,110,4.8,1025,-4141750
398,0,Comedy,10348437,Disorderlies,86,4.8,1708,10348437
399,4000000,Drama,743445,"Sister, Sister",91,5.5,695,-3256555
400,0,Comedy,1584970,Making Mr. Right,98,5.3,2101,1584970
401,0,Horror,225132,White of the Eye,100,6.4,1342,225132
402,0,Drama,2189047,Russkies,100,5.6,1126,2189047
403,15000000,Comedy,5711976,Surrender,105,5.4,692,-9288024
404,0,Comedy,1083282,Housekeeping,116,7.3,1596,1083282
405,0,Drama,213901,The Year My Voice Broke,103,7.5,1647,213901
406,0,Crime,187920,Hell High,84,5.0,464,187920
407,0,Drama,949451,A Man in Love,125,5.8,442,949451
408,0,Comedy,9518342,From the Hip,111,6.2,1826,9518342
409,0,Comedy,1025762,Cross My Heart,90,5.7,883,1025762
410,0,Adventure,3390043,Big Shots,94,5.6,654,3390043
411,14000000,Comedy,20240502,Critical Condition,100,5.2,2453,6240502
412,0,Action,41174,Cyclone,89,4.4,692,41174
413,0,Comedy,2136381,Morgan Stewart's Coming Home,100,5.4,768,2136381
414,0,Action,285885,Cold Steel,91,4.5,592,285885
415,0,Comedy,21905,Zombie High,93,4.2,716,21905
416,0,Comedy,112560,Intervista,100,7.1,1926,112560
417,0,Comedy,3922273,My Demon Lover,90,4.6,945,3922273
418,0,Fantasy,355253,Rumpelstiltskin,84,5.4,444,355253
419,0,Action,307000,World Gone Wild,100,5.2,543,307000
420,0,Action,197791,Enemy Territory,89,6.5,570,197791
421,0,Drama,901364,Julia and Julia,98,5.7,667,901364
422,0,Drama,119919,Crazy Love,90,7.0,949,119919
423,12000000,Drama,2325444,Weeds,115,6.0,717,-9674556
424,0,Drama,760539,The Grand Highway,104,7.5,1208,760539
425,0,Drama,1155020,Peter Kenna's The Good Wife,100,5.8,435,1155020
426,0,Action,295000,Rent-a-Cop,96,4.3,1347,295000
427,0,Comedy,823243,Boyfriends and Girlfriends,103,7.7,2657,823243
428,0,Comedy,1196336,Sammy and Rosie Get Laid,101,6.7,1226,1196336
429,0,Action,4546244,Death Before Dishonor,91,4.9,659,4546244
430,0,Thriller,500283,The Killing Time,94,5.4,763,500283
431,0,Action,200723,Eat the Rich,90,6.0,1069,200723
432,0,Action,205507,The Trouble with Spies,91,4.0,252,205507
433,0,Adventure,22257624,Benji the Hunted,88,6.3,2244,22257624
434,0,Crime,1730337,The Rosary Murders,105,5.7,960,1730337
435,0,Comedy,1092911,Swimming to Cambodia,85,7.8,1763,1092911
436,0,Comedy,1392616,Penitentiary III,90,3.7,372,1392616
437,0,Action,1327740,Steele Justice,95,4.8,403,1327740
438,0,Comedy,215073,Four Adventures of Reinette and Mirabelle,95,7.9,1331,215073
439,0,Comedy,790000,Beyond Therapy,93,4.7,944,790000
440,15000000,Comedy,73707461,Beetlejuice,92,7.5,206997,58707461
441,39000000,Comedy,128152300,Coming to America,116,7.0,130485,89152300
442,9000000,Horror,33244684,Child's Play,87,6.6,67682,24244684
443,28000000,Action,83008852,Die Hard,131,8.2,647000,55008852
444,35000000,Action,57269863,Willow,126,7.3,86056,22269863
445,3000000,Comedy,1108462,Heathers,103,7.3,67238,-1891538
446,25000000,Drama,172825435,Rain Man,133,8.0,408473,147825435
447,4000000,Action,13008928,They Live,94,7.3,83379,9008928
448,70000000,Animation,156452370,Who Framed Roger Rabbit,104,7.7,153513,86452370
449,0,Animation,553171,Akira,124,8.1,118747,553171
450,18000000,Comedy,114968774,Big,104,7.3,164257,96968774
451,20000000,Comedy,78222753,Cocktail,104,5.8,65825,58222753
452,5000000,Drama,11990401,Cinema Paradiso,155,8.5,171600,6990401
453,19000000,Horror,8247943,The Blob,95,6.4,24931,-10752057
454,3500000,Fantasy,4385516,Pumpkinhead,86,6.2,15572,885516
455,7500000,Comedy,63493712,A Fish Called Wanda,108,7.6,114144,55993712
456,2000000,Comedy,15625095,Killer Klowns from Outer Space,88,6.1,25440,13625095
457,30000000,Action,38413606,Midnight Run,126,7.6,58318,8413606
458,3000000,Horror,11090735,Hellbound: Hellraiser II,97,6.5,33241,8090735
459,15000000,Crime,34603943,Mississippi Burning,128,7.8,70539,19603943
460,12000000,Comedy,78041829,The Naked Gun: From the Files of Police Squad!,85,7.6,124515,66041829
461,1100000,Action,11806119,Bloodsport,92,6.8,63368,10706119
462,28000000,Comedy,64000000,Working Girl,113,6.7,44277,36000000
463,14000000,Action,109305000,Crocodile Dundee II,108,5.5,46738,95305000
464,12500000,Animation,48092846,The Land Before Time,69,7.4,66623,35592846
465,15000000,Comedy,111936400,Twins,107,6.0,94295,96936400
466,14000000,Drama,34700000,Dangerous Liaisons,119,7.7,55823,20700000
467,17000000,Drama,10006806,The Unbearable Lightness of Being,171,7.4,28868,-6993194
468,0,Adventure,3500000,The Big Blue,168,7.6,40755,3500000
469,0,Comedy,57041866,Beaches,123,6.8,19613,57041866
470,5000000,Horror,17768757,Halloween 4: The Return of Michael Myers,88,5.9,32498,12768757
471,13000000,Action,45661556,Young Guns,107,6.8,45768,32661556
472,29000000,Action,34994648,Red Heat,104,6.0,53769,5994648
473,6000000,Comedy,12793213,Mystic Pizza,104,6.2,20071,6793213
474,63000000,Action,53715611,Rambo III,102,5.7,99555,-9284389
475,6000000,Drama,32069318,Acusados,111,7.1,26126,26069318
476,7000000,Drama,7630564,The Last Temptation of Christ,164,7.6,42782,630564
477,2000000,Comedy,6671108,Hairspray,92,7.0,17169,4671108
478,0,Comedy,42039085,Dirty Rotten Scoundrels,110,7.3,54129,42039085
479,13000000,Horror,49369899,A Nightmare on Elm Street 4: The Dream Master,93,5.7,39701,36369899
480,0,Drama,13994920,Stand and Deliver,103,7.3,13270,13994920
481,24000000,Comedy,41455230,The Great Outdoors,91,6.6,31340,17455230
482,0,Drama,1547397,Two Moon Junction,104,5.0,4303,1547397
483,7000000,Comedy,50888729,Bull Durham,108,7.1,39369,43888729
484,7500000,Action,18869631,Above the Law,99,6.0,24061,11369631
485,10000000,Comedy,3916303,Earth Girls Are Easy,100,5.2,17315,-6083697
486,31000000,Animation,74151346,Oliver & Company,74,6.7,35531,43151346
487,31000000,Action,37903295,The Dead Pool,91,6.3,33312,6903295
488,7500000,Comedy,5596267,Elvira: Mistress of the Dark,96,6.4,9751,-1903733
489,32000000,Comedy,60328558,Scrooged,101,7.0,68098,28328558
490,23000000,Crime,41292551,Tequila Sunrise,115,6.0,24708,18292551
491,20000000,Crime,17637950,Frantic,120,6.9,41608,-2362050
492,2800000,Horror,19170001,Friday the 13th Part VII: The New Blood,88,5.3,23959,16370001
493,8000000,Comedy,22433275,License to Drive,88,6.3,14929,14433275
494,46630000,Adventure,8083123,The Adventures of Baron Munchausen,126,7.2,43852,-38546877
495,13000000,Drama,9134733,Dead Ringers,116,7.3,32130,-3865267
496,10500000,Horror,14114488,Poltergeist III,98,4.6,14165,3614488
497,7500000,Comedy,2983784,Fright Night Part 2,104,5.9,9005,-4516216
498,3000000,Action,13030057,I'm Gonna Git You Sucka,88,6.6,10455,10030057
499,22000000,Comedy,17550399,Johnny Be Good,91,4.5,5006,-4449601
500,1100000,Action,671382,Maniac Cop,85,6.0,10850,-428618
501,10000000,Comedy,21486757,Married to the Mob,104,6.1,13416,11486757
502,6000000,Action,46616067,Colors,120,6.7,20490,40616067
503,17000000,Comedy,8578231,El Hotel de los Fantasmas,99,5.7,6979,-8421769
504,3000000,Crime,2835116,Running on Empty,116,7.7,11312,-164884
505,1200000,Comedy,3109904,Night of the Demons,90,6.3,9897,1909904
506,13000000,Adventure,6424112,Mac and Me,95,3.4,8043,-6575888
507,4500000,Comedy,3813293,Critters 2,86,5.3,11122,-686707
508,20000000,Comedy,13854000,My Stepmother Is an Alien,105,5.2,22281,-6146000
509,6200000,Comedy,9205924,Return of the Living Dead II,89,5.8,14998,3005924
510,0,Comedy,21630088,Short Circuit 2,110,5.6,19841,21630088
511,22000000,Biography,24720479,Gorillas in the Mist,129,7.0,20378,2720479
512,2000000,Comedy,725131,Vampire's Kiss,103,5.9,10474,-1274869
513,0,Comedy,6264058,A Night in the Life of Jimmy Reardon,90,5.5,2177,6264058
514,0,Comedy,401421,Some Girls,94,6.0,2369,401421
515,2500000,Comedy,1189315,The Lair of the White Worm,93,5.9,7908,-1310685
516,0,Comedy,808114,Waxwork,95,6.2,8703,808114
517,7000000,Fantasy,19595031,The Serpent and the Rainbow,98,6.5,18528,12595031
518,5000000,Family,3569939,Las travesuras de una pelirojja,100,5.9,3474,-1430061
519,6000000,Drama,5680515,Eight Men Out,119,7.3,15946,-319485
520,4700000,Fantasy,1705139,Lady in White,113,6.7,5135,-2994861
521,700000,Comedy,7179298,Women on the Verge of a Nervous Breakdown,88,7.6,27755,6479298
522,0,Comedy,16031707,She's Having a Baby,106,5.8,9676,16031707
523,3000000,Action,7282851,Phantasm II,97,6.5,10789,4282851
524,25000000,Drama,16118077,Luces de una gran ciudad,107,5.6,6165,-8881923
525,0,Action,20036242,The Presidio,97,6.0,13900,20036242
526,0,Comedy,40150487,Big Business,97,6.3,9728,40150487
527,7000000,Drama,5344577,Monkey Shines,113,6.2,8595,-1655423
528,19000000,Comedy,25537221,Funny Farm,101,6.1,16321,6537221
529,0,Comedy,8539181,Without a Clue,107,7.0,7846,8539181
530,16000000,Action,25216243,Alien Nation,91,6.3,12143,9216243
531,0,Drama,5979011,1969,95,5.8,3154,5979011
532,0,Comedy,2955917,976-EVIL,92,5.1,3769,2955917
533,7000000,Action,20257000,Action Jackson,96,5.2,8065,13257000
534,22000000,Comedy,13825794,The Milagro Beanfield War,117,6.9,5289,-8174206
535,23000000,Biography,19652638,Tucker: The Man and His Dream,110,6.9,12469,-3347362
536,0,Comedy,4239831,Police Academy 5: Assignment: Miami Beach,90,4.4,27482,4239831
537,6500000,Comedy,14545844,School Daze,121,5.8,5042,8045844
538,0,Comedy,13664060,Vice Versa,98,5.8,7667,13664060
539,3700000,Action,1145404,Miracle Mile,87,7.0,6985,-2554596
540,0,Comedy,280015,Time of the Gypsies,142,8.3,19943,280015
541,0,Drama,32632093,The Accidental Tourist,121,6.8,13051,32632093
542,17500000,Adventure,18924919,Cocoon: The Return,116,5.3,12956,1424919
543,0,War,161004,The Beast of War,111,7.4,7675,161004
544,4000000,Drama,670774,Apartment Zero,124,6.9,3259,-3329226
545,0,Drama,18875011,The Seventh Sign,97,5.9,11102,18875011
546,0,Drama,15855828,Masquerade,100,6.0,2628,15855828
547,10000000,Drama,1562749,Another Woman,81,7.4,10826,-8437251
548,9000000,Biography,2181286,Bird,161,7.2,9685,-6818714
549,0,Comedy,424773,Drowning by Numbers,118,7.3,6671,424773
550,15000000,Drama,6908797,A Cry in the Dark,120,6.9,7622,-8091203
551,20000000,Comedy,43184798,Biloxi Blues,106,6.6,12590,23184798
552,4000000,Drama,3468572,Talk Radio,110,7.3,10745,-531428
553,0,Adventure,31753898,The Bear,96,7.7,13980,31753898
554,0,Comedy,12277096,Casual Sex?,97,4.9,3279,12277096
555,20000000,Comedy,11798302,Caddyshack II,98,3.7,12956,-8201698
556,18000000,Adventure,1883811,Vibes,99,5.5,2850,-16116189
557,0,Action,29300090,Shoot to Kill,110,6.8,9882,29300090
558,0,Comedy,17514553,For Keeps?,90,5.9,3277,17514553
559,0,Comedy,11536599,Young Einstein,91,5.1,7621,11536599
560,0,Crime,9974446,Criminal Law,117,5.7,2928,9974446
561,0,Comedy,8253123,Satisfaction,92,4.8,2958,8253123
562,19000000,Drama,25816139,Betrayed,127,6.3,4580,6816139
563,0,Drama,8674093,Clean and Sober,124,6.7,4875,8674093
564,0,Action,940173,Al borde del terror,91,5.3,3376,940173
565,16000000,Action,4192440,Escorpion rojo,105,5.0,6925,-11807560
566,0,Mystery,12706478,D.O.A.,96,6.1,8364,12706478
567,0,Crime,960040,Appointment with Death,100,6.2,2554,960040
568,0,Crime,2080046,Salaam Bombay!,113,8.0,7139,2080046
569,0,Drama,3966256,Bat*21,105,6.4,6651,3966256
570,0,Adventure,13687027,Return to Snowy River,110,6.6,1943,13687027
571,6000000,Horror,40397,Pulse,95,5.5,1781,-5959603
572,0,Drama,7467504,Stealing Home,98,6.8,3633,7467504
573,0,Comedy,10815378,Moving,89,6.1,4139,10815378
574,0,Comedy,2567099,18 Again!,93,5.7,3573,2567099
575,14000000,Drama,6640346,Fresh Horses,105,5.0,1439,-7359654
576,0,Comedy,4865997,Torch Song Trilogy,120,7.7,5834,4865997
577,5000000,Action,3588626,Dead Heat,86,6.0,5127,-1411374
578,210000,Comedy,107352,Not of This Earth,81,4.5,1724,-102648
579,15000000,Drama,1733070,Little Nikita,98,6.0,4132,-13266930
580,15000000,Comedy,21032267,Punchline,128,5.8,6938,6032267
581,0,Action,5855392,The Rescue,100,5.4,920,5855392
582,0,Action,6193901,Braddock: Missing in Action III,101,4.7,4679,6193901
583,0,Action,10497324,Iron Eagle II,100,3.6,4195,10497324
584,0,Biography,201055,Camille Claudel,158,7.3,5243,201055
585,0,Adventure,15122324,Big Top Pee-wee,86,4.9,7756,15122324
586,0,Crime,1791328,Stormy Monday,93,6.3,2958,1791328
587,0,Drama,303624,The Chocolate War,100,6.9,1784,303624
588,0,Crime,8440,As Tears Go By,102,7.1,6485,8440
589,0,Drama,1938049,Spellbinder,99,5.8,1633,1938049
590,8000000,Drama,784990,The Boost,95,6.1,1629,-7215010
591,20000000,Comedy,11444204,Moon Over Parador,103,5.9,4778,-8555796
592,6000000,Comedy,28202109,Ernest Saves Christmas,95,5.6,8513,22202109
593,0,Drama,2326900,A World Apart,100,7.1,1234,2326900
594,3000000,Crime,1884315,Cop,110,6.4,3419,-1115685
595,0,Comedy,540000,Buster,91,5.8,2767,540000
596,4000000,Comedy,16262415,Crossing Delancey,97,6.9,2935,12262415
597,0,Drama,241278,Paperhouse,92,6.8,4568,241278
598,0,Drama,5194491,Clara's Heart,100,6.3,1821,5194491
599,6000000,Action,10068039,Shakedown,93,5.9,2087,4068039
600,19000000,Comedy,11005304,The Couch Trip,97,5.7,3961,-7994696
601,0,Animation,370698,Gandahar,78,7.1,3196,370698
602,8000000,Drama,1893139,Permanent Record,91,6.4,1550,-6106861
603,6000000,Drama,1869148,The Kiss,101,5.5,1258,-4130852
604,0,Romance,410109,36 fillette,88,6.0,938,410109
605,0,Action,5301200,Hero and the Terror,96,5.2,2626,5301200
606,0,Comedy,6436211,Hot to Trot,100,4.4,2666,6436211
607,0,Drama,12638294,Everybody's All-American,127,6.2,2558,12638294
608,0,Drama,229556,Judgement in Berlin,96,5.9,571,229556
609,0,Comedy,717376,And God Created Woman,100,4.3,1487,717376
610,0,Comedy,1192322,High Hopes,108,7.6,3235,1192322
611,14000000,Drama,4764606,The Good Mother,100,5.9,1361,-9235394
612,19000000,Crime,4594452,Sunset,102,5.7,3333,-14405548
613,0,Crime,191051,For Queen & Country,105,5.7,1851,191051
614,0,Drama,113275,Heart of Midnight,93,5.3,908,113275
615,0,Drama,187349,Rocket Gibraltar,99,6.6,1594,187349
616,1000000,Crime,492519,Jack's Back,97,6.0,1968,-507481
617,0,Comedy,343786,Tapeheads,93,5.8,3411,343786
618,0,Drama,1560700,A Handful of Dust,100,6.8,1519,1560700
619,5000000,Drama,429028,Track 29,100,5.9,1563,-4570972
620,0,Romance,8892589,Salsa,98,4.9,900,8892589
621,4000000,Horror,9797098,Bad Dreams,84,5.6,2583,5797098
622,0,Comedy,111987,Stars and Bars,94,4.8,689,111987
623,0,Comedy,344375,It Takes Two,81,5.7,519,344375
624,0,Biography,1223326,Patty Hearst,108,6.3,1064,1223326
625,0,Comedy,14681192,Arthur 2: On the Rocks,113,4.3,5270,14681192
626,13000000,Comedy,5509417,Heartbreak Hotel,97,5.7,1017,-7490583
627,0,Drama,438483,Story of Women,108,7.6,3109,438483
628,0,Comedy,124880,The In Crowd,95,6.3,640,124880
629,0,Action,426965,Last Rites,103,5.2,867,426965
630,0,Action,3074681,Messenger of Death,91,5.5,1806,3074681
631,0,War,1348771,Platoon Leader,97,5.4,1193,1348771
632,0,Comedy,2011497,The Moderns,126,6.7,1410,2011497
633,18000000,Comedy,9129999,Switching Channels,105,5.9,2789,-8870001
634,0,Drama,2317091,Chocolat,105,7.4,2217,2317091
635,0,Drama,315421,Crusoe,91,6.3,759,315421
636,0,Drama,688329,"Distant Voices, Still Lives",85,7.5,2626,688329
637,0,Drama,462813,A Summer Story,95,7.5,738,462813
638,0,Comedy,1152786,The Wrong Guys,100,5.0,637,1152786
639,0,Action,7242035,Off Limits,102,6.2,2154,7242035
640,0,Comedy,3838793,Feds,90,5.3,2530,3838793
641,14000000,Thriller,459824,The House on Carroll Street,101,6.2,1844,-13540176
642,0,Action,159969,Taffin,96,5.6,1194,159969
643,0,Drama,3076031,Dominick and Eugene,111,7.1,2409,3076031
644,0,Biography,331469,Salome's Last Dance,89,6.7,1110,331469
645,13000000,Comedy,259019,Illegally Yours,102,4.2,734,-12740981
646,0,Drama,422667,Tiger Warsaw,100,4.7,615,422667
647,0,Crime,2432536,Kansas,100,5.4,766,2432536
648,0,Comedy,1221366,Mr. North,93,5.9,1077,1221366
649,0,Horror,6337299,The Unholy,102,4.9,1123,6337299
650,0,Action,188964,Miles from Home,108,5.7,1117,188964
651,0,Comedy,3527886,Things Change,100,7.0,2644,3527886
652,5000000,Action,807947,Bulletproof,93,5.0,1057,-4192053
653,12000000,Comedy,3965604,Memories of Me,100,5.7,789,-8034396
654,0,Comedy,3790493,Sweet Hearts Dance,100,5.7,680,3790493
655,1600000,Comedy,419428,Out of the Dark,89,5.4,593,-1180572
656,0,Adventure,346297,The Deceivers,102,6.1,795,346297
657,7000000,Horror,136203,Cameron's Closet,100,4.9,704,-6863797
658,0,Action,1333379,The Navigator: A Medieval Odyssey,90,7.0,2661,1333379
659,0,Comedy,169785,Pass the Ammo,93,6.1,414,169785
660,16400000,Comedy,95860116,Dead Poets Society,128,8.0,301100,79460116
661,35000000,Action,251188924,Batman,126,7.6,288860,216188924
662,11500000,Horror,57469179,Pet Sematary,103,6.6,70178,45969179
663,48000000,Action,197171806,Indiana Jones and the Last Crusade,127,8.3,566432,149171806
664,40000000,Animation,111543479,The Little Mermaid,83,7.6,188455,71543479
665,55000000,Action,63408614,Tango & Cash,104,6.3,81242,8408614
666,17000000,Action,30050028,Road House,114,6.5,47394,13050028
667,27000000,Comedy,71320000,National Lampoon's Christmas Vacation,97,7.6,115848,44320000
668,10000000,Adventure,40485039,Bill & Ted's Excellent Adventure,90,6.9,90901,30485039
669,0,Drama,64431625,Field of Dreams,107,7.5,91800,64431625
670,40000000,Adventure,118500000,Back to the Future Part II,108,7.8,377402,78500000
671,70000000,Adventure,54461047,The Abyss,145,7.6,140371,-15538953
672,15000000,Comedy,66758538,Uncle Buck,100,7.0,68231,51758538
673,6500000,Comedy,27545445,Do the Right Thing,120,7.9,65617,21045445
674,0,Adventure,30218387,Weekend at Bernie's,97,6.4,40910,30218387
675,18000000,Biography,26830000,Glory,122,7.9,107207,8830000
676,16000000,Comedy,92823600,When Harry Met Sally...,96,7.6,161347,76823600
677,0,Comedy,83759091,Steel Magnolias,117,7.2,37333,83759091
678,37000000,Action,112494738,Ghostbusters II,108,6.5,152597,75494738
679,0,Comedy,20781385,Say Anything...,100,7.4,70820,20781385
680,7500000,Comedy,140088813,Look Who's Talking,93,5.8,67535,132588813
681,25000000,Adventure,15704614,Leviathan,98,5.8,14315,-9295386
682,18000000,Adventure,130724172,"Honey, I Shrunk the Kids",93,6.3,116845,112724172
683,11000000,Comedy,49797148,Major League,107,7.2,52280,38797148
684,14000000,Biography,70001698,Born on the Fourth of July,145,7.2,82727,56001698
685,0,Action,38956288,The Karate Kid Part III,112,5.0,38560,38956288
686,0,Comedy,36602000,The 'Burbs,101,6.9,55800,36602000
687,31000000,Comedy,100047830,Parenthood,124,7.0,37913,69047830
688,28000000,Action,147253986,Lethal Weapon 2,114,7.2,137637,119253986
689,32000000,Action,34667015,Licence to Kill,133,6.6,79153,2667015
690,0,Drama,11060485,Wild Orchid,105,4.5,9667,11060485
691,0,Biography,14743391,My Left Foot,103,7.9,54654,14743391
692,0,Adventure,793775,Little Monsters,100,6.1,8801,793775
693,31000000,Fantasy,43858790,Always,122,6.4,23834,12858790
694,1200000,Drama,24741700,"Sex, Lies, and Videotape",100,7.2,40625,23541700
695,10000000,Drama,31906454,Lean on Me,108,7.4,15445,21906454
696,0,Crime,7724701,"The Cook, the Thief, His Wife & Her Lover",124,7.6,28906,7724701
697,27800000,Action,52210049,Star Trek V: The Final Frontier,107,5.4,47303,24410049
698,7500000,Drama,106593296,Driving Miss Daisy,99,7.4,79478,99093296
699,10000000,Action,2777280,Gleaming the Cube,100,6.2,5688,-7222720
700,22500000,Crime,18671317,Casualties of War,113,7.1,35439,-3828683
701,0,Comedy,27843,Teen Witch,90,6.2,6711,27843
702,18000000,Comedy,46908987,"See No Evil, Hear No Evil",103,6.8,40102,28908987
703,1500000,Action,14697005,Kickboxer,97,6.4,40427,13197005
704,6000000,Fantasy,22168359,A Nightmare on Elm Street 5: The Dream Child,89,5.1,32517,16168359
705,3000000,Horror,11642254,Halloween 5,96,5.2,25314,8642254
706,0,Comedy,71079915,Turner & Hooch,97,6.1,52638,71079915
707,0,Horror,7825009,Terror a bordo,96,6.8,31343,7825009
708,5000000,Adventure,14343976,Friday the 13th Part VIII: Jason Takes Manhattan,100,4.6,25441,9343976
709,30000000,Comedy,60864870,Harlem Nights,116,5.9,15602,30864870
710,30000000,Action,46212055,Black Rain,125,6.6,42038,16212055
711,13800000,Animation,27100027,All Dogs Go to Heaven,84,6.7,29118,13300027
712,500000,Action,10166459,Cyborg,86,5.0,24943,9666459
713,8000000,Comedy,35150960,Fletch Lives,95,6.1,16426,27150960
714,6000000,Adventure,14278900,The Wizard,96,6.0,11308,8278900
715,0,Comedy,86888546,The War of the Roses,116,6.8,40673,86888546
716,9000000,Action,10161099,Henry V,137,7.7,24726,1161099
717,18000000,Adventure,8508843,Troop Beverly Hills,105,5.5,7942,-9491157
718,19000000,Crime,58571513,Sea of Love,113,6.8,32138,39571513
719,5000000,Action,1700000,Best of the Best,97,6.4,10215,-3300000
720,0,Horror,20021322,The Fly II,105,4.9,18023,20021322
721,0,Action,8220000,Blue Steel,102,5.6,9921,8220000
722,0,Comedy,3960327,Loverboy,98,5.9,5949,3960327
723,33000000,Drama,1132112,Valmont relaciones peligrosas,137,7.0,10789,-31867888
724,2500000,Crime,4729352,Drugstore Cowboy,102,7.4,26923,2229352
725,0,Comedy,4087361,Tie Me Up! Tie Me Down!,101,7.0,19654,4087361
726,0,Comedy,5552441,Dream a Little Dream,114,5.9,5231,5552441
727,7000000,Action,9094451,Warlock,103,6.2,12449,2094451
728,35000000,Family,1368210,Little Nemo: Adventures in Slumberland,85,7.2,5800,-33631790
729,0,Drama,536508,Eddie and the Cruisers II: Eddie Lives!,99,6.2,2273,536508
730,24000000,Crime,22099847,Lock Up,109,6.4,32079,-1900153
731,3000000,Horror,76325,After Midnight,90,5.6,1173,-2923675
732,0,Drama,5777099,Millennium,108,5.7,5238,5777099
733,5000000,Comedy,6157157,UHF,97,7.0,22399,1157157
734,13000000,Drama,16823529,The Fabulous Baker Boys,114,6.8,18751,3823529
735,5000000,Comedy,6957975,Shag,98,6.3,3203,1957975
736,19000000,Comedy,18254702,Crimes and Misdemeanors,104,8.0,46269,-745298
737,2800000,Comedy,367879,Mystery Train,110,7.6,20241,-2432121
738,0,Biography,13741060,Great Balls of Fire!,108,6.2,13448,13741060
739,8000000,Action,8143225,DeepStar Six,105,5.2,7701,143225
740,5000000,Comedy,16554699,Shocker,109,5.4,12181,11554699
741,15000000,Action,40590000,Three Fugitives,96,6.1,9199,25590000
742,0,Comedy,6353913,Shirley Valentine,108,7.2,5718,6353913
743,10000000,Action,2692037,Blind Fury,86,6.3,11576,-7307963
744,12000000,Action,15942628,Next of Kin,108,5.7,7644,3942628
745,15000000,Comedy,10763469,New York Stories,124,6.4,14652,-4236531
746,10000000,Action,1272977,Robot Jox,85,5.3,4665,-8727023
747,15000000,Comedy,28890240,The Dream Team,113,6.5,10768,13890240
748,0,Comedy,15351421,She-Devil,99,5.5,13531,15351421
749,4000000,Sci-Fi,192816,The Return of Swamp Thing,84,4.5,3054,-3807184
750,0,Crime,12195695,Family Business,110,5.7,10221,12195695
751,20000000,Comedy,10555348,We're No Angels,106,6.0,18558,-9444652
752,16000000,Comedy,16278590,Chances Are,108,6.4,9105,278590
753,20000000,Crime,7237794,Johnny Handsome,94,6.1,7483,-12762206
754,17000000,Action,43247647,K-9,101,6.0,27310,26247647
755,0,Drama,8800000,Scandal,115,6.5,3972,8800000
756,0,Drama,3953745,The Phantom of the Opera,93,5.5,3032,3953745
757,0,Biography,3563162,Fat Man and Little Boy,127,6.5,5811,3563162
758,0,Action,20047604,An Innocent Man,113,6.4,5088,20047604
759,19000000,Action,12143484,Pink Cadillac,122,5.3,9301,-6856516
760,0,Comedy,12065892,She's Out of Control,90,5.3,3316,12065892
761,0,Comedy,10982364,Who's Harry Crumb?,94,5.8,13375,10982364
762,8000000,Action,16093651,No Holds Barred,93,4.3,4966,8093651
763,0,Comedy,19674852,Skin Deep,97,6.1,3318,19674852
764,3000000,Horror,1738897,The Horror Show,95,4.9,2627,-1261103
765,0,Action,4557214,The Mighty Quinn,98,6.1,3782,4557214
766,12000000,Comedy,11567217,Police Academy 6: City Under Siege,84,4.2,23683,-432783
767,19000000,Drama,19738015,Dad,117,6.2,3891,738015
768,0,Drama,1730005,Last Exit to Brooklyn,102,6.9,4841,1730005
769,0,Action,882290,The Blood of Heroes,90,6.5,5155,882290
770,0,Drama,3766879,A Dry White Season,97,7.0,3879,3766879
771,13000000,Comedy,22030000,Cousins,109,6.3,3667,9030000
772,5000000,Biography,1919653,Communion,106,5.7,4489,-3080347
773,0,Comedy,1932642,Erik the Viking,107,6.2,11465,1932642
774,3000000,Comedy,870532,Parents,81,6.2,4968,-2129468
775,5000000,Comedy,117463,The Big Picture,100,6.3,4057,-4882537
776,18000000,Action,10647219,The Package,108,6.4,6979,-7352781
777,0,Comedy,9114702,Tap,111,6.5,1195,9114702
778,0,Fantasy,151203,"I, Madman",89,6.1,2093,151203
779,0,Action,4611062,The January Man,97,5.6,5405,4611062
780,0,Biography,19131246,Blaze,120,5.9,3129,19131246
781,18000000,Comedy,4973285,Let It Ride,90,6.9,4382,-13026715
782,0,Drama,2049769,Jacknife,102,6.4,4749,2049769
783,18000000,Drama,3531971,In Country,120,5.9,2385,-14468029
784,3000000,Drama,4609953,Longtime Companion,96,7.5,4560,1609953
785,0,Comedy,18699037,Her Alibi,94,5.7,5902,18699037
786,0,Comedy,3077361,Cannonball Fever,94,4.3,2615,3077361
787,4000000,Action,283694,Kill Me Again,94,6.3,3576,-3716306
788,2300000,Action,792966,The Toxic Avenger Part II,102,5.1,5067,-1507034
789,0,Comedy,6291444,The Gods Must Be Crazy II,98,6.8,13810,6291444
790,2500000,Comedy,43749,Wicked Stepmother,90,4.1,1370,-2456251
791,0,Crime,6263883,Music Box,124,7.4,5638,6263883
792,0,Comedy,3473905,The Lemon Sisters,93,4.9,618,3473905
793,0,Drama,18587135,Prancer,103,6.3,3478,18587135
794,0,Comedy,169203,The Experts,94,4.7,1990,169203
795,0,Drama,4347648,Lisa,95,5.9,1103,4347648
796,1500000,Horror,1519796,Stepfather II,93,5.6,2468,19796
797,0,Drama,8742750,True Believer,105,6.7,3633,8742750
798,0,Action,3416846,Kinjite: Forbidden Subjects,97,5.4,2162,3416846
799,0,Comedy,510712,The Tall Guy,92,6.2,3878,510712
800,0,Drama,1097333,Heart of Dixie,95,5.2,569,1097333
801,0,Action,8125592,Dead Bang,102,6.1,2720,8125592
802,0,Comedy,938065,Sweetie,97,6.9,2603,938065
803,75000,Comedy,546541,The Unbelievable Truth,90,7.5,3877,471541
804,0,Drama,11604598,Gross Anatomy,100,6.1,3204,11604598
805,0,Action,902152,American Ninja 3: Blood Hunt,89,3.4,4048,902152
806,0,Comedy,418053,How to Get Ahead in Advertising,90,7.0,4584,418053
807,0,Action,444055,The Rainbow,113,6.4,1018,444055
808,0,Action,363561,The Toxic Avenger Part III: The Last Temptation of Toxie,102,4.4,3562,363561
809,0,Drama,4299023,Listen to Me,107,5.3,882,4299023
810,0,Drama,2023282,Winter People,110,6.3,1029,2023282
811,0,Comedy,7754571,Enemies: A Love Story,119,6.8,1705,7754571
812,0,Action,1960,Violent Cop,103,7.2,8597,1960
813,11500000,Drama,2260616,Sing,98,6.8,597,-9239384
814,0,Drama,1601612,Jesus of Montreal,118,7.5,6162,1601612
815,34000000,Adventure,3574256,Old Gringo,100,5.8,1556,-30425744
816,20000000,Action,2420917,Farewell to the King,117,6.3,2282,-17579083
817,0,Action,9015164,Renegades,106,5.3,2585,9015164
818,16000000,Adventure,67878,Brenda Starr,93,4.6,856,-15932122
819,0,Comedy,3690400,Worth Winning,103,6.0,1378,3690400
820,0,Comedy,4348025,Staying Together,91,6.3,639,4348025
821,0,Drama,1247946,Lost Angels,116,6.1,758,1247946
822,0,Drama,154264,84C MoPic,95,7.0,1461,154264
823,0,Comedy,2156471,Scenes from the Class Struggle in Beverly Hills,103,6.2,872,2156471
824,0,Horror,858591,The Terror Within,88,4.9,958,858591
825,0,Biography,1316495,Romero,102,7.3,1789,1316495
826,0,Crime,6985999,Relentless,92,5.9,1064,6985999
827,0,Drama,201468,The Rachel Papers,95,6.1,1621,201468
828,14000000,Drama,5932613,Immediate Family,95,6.1,1235,-8067387
829,0,Comedy,682016,My Twentieth Century,100,7.1,692,682016
830,0,Action,7723506,Disorganized Crime,98,6.3,1842,7723506
831,0,Biography,1089000,Wired,112,4.4,685,1089000
832,0,Biography,408839,Triumph of the Spirit,120,6.9,1834,408839
833,0,Crime,1417030,Monsieur Hire,81,7.7,4920,1417030
834,0,Comedy,3169719,Rude Awakening,100,4.4,1123,3169719
835,0,Biography,259486,Chattahoochee,94,6.4,1524,259486
836,0,Comedy,1642239,How I Got Into College,86,5.8,1807,1642239
837,0,Comedy,5368865,Second Sight,83,4.4,983,5368865
838,0,Adventure,535031,River of Death,107,4.2,783,535031
839,0,Comedy,646890,Miss Firecracker,102,6.1,1706,646890
840,0,Drama,4795000,See You in the Morning,119,5.8,720,4795000
841,17000000,Crime,3560932,Physical Evidence,99,5.1,1238,-13439068
842,0,Comedy,1869417,Cookie,94,5.2,929,1869417
843,4000000,Comedy,43671,Bloodhounds of Broadway,93,5.7,1021,-3956329
844,0,Drama,283747,Powwow Highway,100,7.3,1374,283747
845,0,Comedy,1354268,True Love,104,6.0,599,1354268
846,5000000,Adventure,8153677,Cheetah,83,6.1,703,3153677
847,0,Comedy,495063,"Mama, There's a Man in Your Bed",100,6.9,1286,495063
848,0,Comedy,289975,Cold Feet,94,4.7,313,289975
849,0,Horror,102219,Edge of Sanity,85,5.3,1070,102219
850,0,Comedy,472340,Fast Food,92,4.3,486,472340
851,0,Comedy,960385,Getting It Right,100,6.5,579,960385
852,0,Action,2043889,Rooftops,98,4.6,341,2043889
853,0,Comedy,294266,Out Cold,92,5.5,592,294266
854,0,Drama,333811,Dark Obsession,100,4.8,276,333811
855,0,Crime,197343,Mortal Passions,100,4.8,215,197343
856,0,Drama,463972,Slaves of New York,124,5.4,773,463972
857,0,Horror,166635,Night Visitor,93,4.5,383,166635
858,0,Comedy,216373,A Chorus of Disapproval,100,5.7,607,216373
859,0,Action,618178,Cage,100,4.9,482,618178
860,0,Action,1770082,Bloodfist,85,4.8,849,1770082
861,0,Thriller,337812,Night Game,95,4.9,498,337812
862,6000000,Adventure,1877618,Breaking In,94,6.1,1209,-4122382
863,0,Drama,764794,Strapless,100,5.8,322,764794
864,0,Drama,428758,Life and Nothing But,100,7.5,1227,428758
865,0,Comedy,1776440,Too Beautiful for You,91,6.7,2117,1776440
866,0,Comedy,574080,Rosalie Goes Shopping,94,6.0,690,574080
867,0,Drama,111747,Torrents of Spring,100,6.0,262,111747
868,0,Comedy,491193,How to Make Love to a Negro Without Getting Tired,100,4.6,266,491193
869,0,Action,221163,Fist Fighter,100,5.0,199,221163
870,0,Drama,1029822,Welcome Home,92,5.7,261,1029822
871,0,Comedy,235011,Chameleon Street,94,7.1,386,235011
872,0,Comedy,1236844,Queen of Hearts,112,6.9,406,1236844
873,0,Drama,95836,Signs of Life,90,6.3,319,95836
874,0,Action,862551,Crack House,90,5.6,295,862551
875,0,Comedy,129778,Martians Go Home,89,2.8,605,129778
876,0,Drama,161323,Bye Bye Blues,117,7.2,260,161323
877,0,Comedy,3400000,Cruising Bar,96,6.8,849,3400000
878,0,Comedy,75868,"Bert Rigby, You're a Fool",94,6.1,217,75868
879,0,Comedy,192561,Beverly Hills Brats,90,3.9,233,192561
880,26000000,Drama,61490000,Flatliners,115,6.6,67242,35490000
881,25000000,Crime,46836394,Goodfellas,146,8.7,802599,21836394
882,0,Drama,4960385,The Handmaid's Tale,109,6.0,6298,4960385
883,20000000,Crime,61276872,Misery,107,7.8,147278,41276872
884,65000000,Action,119394840,El vengador del futuro,113,7.5,257253,54394840
885,14000000,Comedy,178406268,Pretty Woman,119,7.0,233319,164406268
886,18000000,Comedy,285761243,Home Alone,103,7.5,350395,267761243
887,20000000,Drama,56362352,Edward Scissorhands,105,7.9,384404,36362352
888,54000000,Crime,66666062,The Godfather: Part III,162,7.6,295736,12666062
889,22000000,Adventure,184208848,Dances with Wolves,181,8.0,201166,162208848
890,30000000,Action,122012643,The Hunt for Red October,135,7.6,152517,92012643
891,13000000,Horror,28501605,Child's Play 2,84,5.8,34608,15501605
892,22000000,Drama,217631306,Ghost,127,7.0,164846,195631306
893,11000000,Comedy,16667084,Tremors,96,7.1,98220,5667084
894,25000000,Comedy,39404261,Joe Versus the Volcano,102,5.7,29752,14404261
895,9500000,Comedy,14560247,Wild at Heart,125,7.2,67407,5060247
896,0,Adventure,10360553,The Witches,91,6.8,27253,10360553
897,25000000,Drama,26118851,Jacob's Ladder,113,7.5,81979,1118851
898,13500000,Action,135265915,Teenage Mutant Ninja Turtles,93,6.7,73504,121765915
899,31000000,Comedy,53208180,Arachnophobia,103,6.4,53559,22208180
900,70000000,Action,117540947,Die Hard 2,124,7.1,288815,47540947
901,47000000,Action,103738726,Dick Tracy,105,6.1,50318,56738726
902,0,Biography,52096475,Awakenings,121,7.8,101286,52096475
903,0,Adventure,13985225,Lord of the Flies,90,6.4,23976,13985225
904,10000000,Comedy,53470900,Problem Child,81,5.3,24008,43470900
905,60000000,Action,82670733,Days of Thunder,107,5.9,65262,22670733
906,11000000,Comedy,8266343,Cry-Baby,85,6.5,47001,-2733657
907,40000000,Adventure,87727583,Back to the Future Part III,118,7.4,316774,47727583
908,42000000,Drama,40946358,Rocky V,104,5.2,102375,-1053642
909,26000000,Comedy,91457688,Kindergarten Cop,111,6.1,115309,65457688
910,35000000,Action,30669413,Predator 2,108,6.2,117081,-4330587
911,36000000,Adventure,17373527,The NeverEnding Story II: The Next Chapter,90,5.1,19726,-18626473
912,35000000,Action,45681173,RoboCop 2,117,5.8,68761,10681173
913,14000000,Crime,5080409,Miller's Crossing,115,7.8,110371,-8919591
914,0,Horror,5765562,Leatherface: Texas Chainsaw Massacre III,81,5.2,10775,5765562
915,40000000,Action,21413502,The Adventures of Ford Fairlane,104,6.3,15191,-18586498
916,0,Action,5017971,La Femme Nikita,117,7.4,58619,5017971
917,16000000,Action,33878502,Darkman,96,6.4,50571,17878502
918,22000000,Mystery,86303188,Presumed Innocent,127,6.9,31512,64303188
919,50000000,Comedy,41482207,Gremlins 2: The New Batch,106,6.3,75271,-8517793
920,11000000,Action,8862354,Nightbreed,102,6.5,15692,-2137646
921,31000000,Comedy,35419397,Mermaids,110,6.6,23765,4419397
922,4200000,Horror,5835247,Night of the Living Dead,92,6.9,33142,1635247
923,3500000,Comedy,16324573,Tales from the Darkside: The Movie,93,6.2,12090,12824573
924,0,Action,1911542,State of Grace,134,7.3,17766,1911542
925,3000000,Action,24078196,Lionheart,108,6.1,27025,21078196
926,0,Action,15650000,Revenge,124,6.2,13517,15650000
927,0,Comedy,47489074,Look Who's Talking Too,81,4.5,38981,47489074
928,10000000,Action,47410000,Hard to Kill,96,5.7,23411,37410000
929,0,Biography,2060847,The Krays,115,6.7,6422,2060847
930,0,Drama,26098824,The Exorcist III,110,6.3,19380,26098824
931,0,Crime,1293976,The Hot Spot,130,6.4,8618,1293976
932,0,Biography,11567449,Henry & June,136,6.3,10779,11567449
933,10500000,Horror,11582891,Graveyard Shift,89,4.8,7613,1082891
934,0,Crime,2554476,El verdugo de Nueva York,103,7.0,25511,2554476
935,30000000,Animation,27931461,The Rescuers Down Under,100,6.9,30141,-2068539
936,20000000,Action,44143410,Young Guns II,104,6.5,25680,24143410
937,2500000,Comedy,26386000,House Party,100,6.3,9303,23886000
938,0,Drama,20710451,Hamlet,135,6.8,18778,20710451
939,0,Comedy,11541758,Pump Up the Volume,102,7.2,22643,11541758
940,5200000,Action,2459895,Class of 1999,99,5.8,5119,-2740105
941,12000000,Action,46044400,Marked for Death,93,5.9,16347,34044400
942,35000000,Action,31053601,Air America,113,5.7,23326,-3946399
943,10000000,Action,21633874,The Rookie,120,5.8,21622,11633874
944,0,Crime,27734391,Internal Affairs,115,6.5,14195,27734391
945,0,Comedy,739104,Rosencrantz & Guildenstern Are Dead,117,7.6,18087,739104
946,0,Action,25069101,Navy Seals,113,5.5,13756,25069101
947,20000000,Action,21413105,Quigley Down Under,119,6.8,16185,1413105
948,18000000,Thriller,29381956,Pacific Heights,102,6.4,15129,11381956
949,47000000,Comedy,15691192,The Bonfire of the Vanities,125,5.5,18886,-31308808
950,25000000,Comedy,6939946,Almost an Angel,95,5.4,3294,-18060054
951,12000000,Drama,1963207,Dreams,119,7.8,19625,-10036793
952,1500000,Sci-Fi,5728953,Hardware,94,5.9,10546,4228953
953,0,Animation,18115724,DuckTales the Movie: Treasure of the Lost Lamp,74,6.9,21633,18115724
954,0,Drama,17487531,White Palace,103,6.5,6227,17487531
955,23000000,Action,27441977,Memphis Belle,107,6.9,23909,4441977
956,7000000,Action,4348368,Dark Angel,91,6.0,8214,-2651632
957,0,Comedy,9888167,Miami Blues,97,6.4,6524,9888167
958,20000000,Action,70980000,Bird on a Wire,110,5.9,33453,50980000
959,0,Drama,1244381,The Comfort of Strangers,107,6.4,3405,1244381
960,18000000,Action,2742912,Desperate Hours,105,5.4,5702,-15257088
961,38000000,Action,80818974,Another 48 Hrs.,93,5.8,32058,42818974
962,0,Action,16247964,Men at Work,98,5.9,19392,16247964
963,0,Comedy,71609321,3 Men and a Little Lady,104,5.3,18817,71609321
964,22000000,Comedy,37963281,Postcards from the Edge,101,6.7,12832,15963281
965,15000000,Comedy,15260154,Quick Change,89,6.8,16870,260154
966,0,Comedy,23591472,My Blue Heaven,97,6.2,16370,23591472
967,0,Comedy,21460601,The Freshman,102,6.5,16570,21460601
968,0,Crime,13446769,The Grifters,110,7.0,22008,13446769
969,19000000,Crime,10005969,The Two Jakes,137,6.1,9111,-8994031
970,4000000,Action,16853487,Death Warrant,89,5.6,13783,12853487
971,0,Biography,15140007,Cyrano de Bergerac,137,7.6,19222,15140007
972,0,Biography,15445131,Reversal of Fortune,111,7.3,12127,15445131
973,0,Comedy,16186793,I Love You to Death,97,6.4,11639,16186793
974,2500000,Comedy,205068,Frankenhooker,85,6.1,6877,-2294932
975,0,Action,1494969,A Cry in the Wild,82,5.4,786,1494969
976,0,Drama,1414017,The Field,107,7.4,4645,1414017
977,20000000,Comedy,15379253,Mr. Destiny,110,6.3,10006,-4620747
978,0,Drama,22998000,The Russia House,123,6.1,12274,22998000
979,0,Comedy,4134992,Heart Condition,100,5.6,2613,4134992
980,0,Comedy,29888235,Green Card,103,6.2,19613,29888235
981,10000000,Drama,16153600,Mo' Better Blues,129,6.6,8969,6153600
982,0,Crime,141864,Days of Being Wild,100,7.6,13450,141864
983,23000000,Drama,5820015,Stanley & Iris,104,6.3,5877,-17179985
984,22000000,Action,14760451,Fire Birds,85,4.7,5036,-7239549
985,7000000,Drama,12626043,Bad Influence,99,6.2,6062,5626043
986,0,Comedy,20005435,Taking Care of Business,108,6.4,6535,20005435
987,0,Comedy,1516414,Life Is Sweet,103,7.5,6911,1516414
988,0,Comedy,1554742,Truly Madly Deeply,106,7.3,6378,1554742
989,25000000,Adventure,2075084,The Sheltering Sky,138,6.8,9389,-22924916
990,0,Biography,2670,Close-Up,98,8.3,10254,2670
991,40000000,Drama,9243140,Havana,144,6.1,6021,-30756860
992,0,Comedy,3989297,"Welcome Home, Roxy Carmichael",95,5.9,4051,3989297
993,0,Comedy,1155800,The Hairdresser's Husband,82,7.4,7465,1155800
994,0,Comedy,1382462,Repossessed,80,4.8,6879,1382462
995,0,Action,6488144,Flashback,108,6.2,4152,6488144
996,0,Comedy,27627310,Cadillac Man,97,5.6,11388,27627310
997,0,Action,358047,American Ninja 4: The Annihilation,99,3.8,3660,358047
998,9000000,Horror,349618,Two Evil Eyes,120,6.1,4726,-8650382
999,12000000,Comedy,7331647,Alice,106,6.6,11331,-4668353
1000,0,Drama,17037887,The Guardian,92,5.3,4004,17037887
1001,0,Action,10873237,Narrow Margin,97,6.6,6377,10873237
1002,24000000,Adventure,2319124,White Hunter Black Heart,112,6.7,9279,-21680876
1003,0,Action,6698361,Delta Force 2: The Colombian Connection,111,4.7,5538,6698361
1004,225000,Comedy,2938208,Metropolitan,98,7.5,7776,2713208
1005,700000,Comedy,356122,Trust,107,7.5,7712,-343878
1006,0,Comedy,1171762,The Boyfriend School,100,5.9,1943,1171762
1007,0,Family,3299382,Happily Ever After,75,5.1,1876,3299382
1008,2000000,Horror,1627955,Brain Dead,85,6.1,2792,-372045
1009,0,Crime,11207891,Q & A,132,6.5,4235,11207891
1010,0,Drama,15740796,Avalon,128,7.3,5052,15740796
1011,0,Drama,2070871,Cadence,97,6.6,4621,2070871
1012,0,Adventure,4011793,Mountains of the Moon,136,7.3,2938,4011793
1013,0,Comedy,24707633,Ghost Dad,83,4.3,6587,24707633
1014,0,Biography,1054638,An Angel at My Table,158,7.6,5390,1054638
1015,0,Comedy,13236513,Crazy People,90,5.9,3612,13236513
1016,0,Drama,4263112,Lambada,104,3.2,860,4263112
1017,0,Comedy,25029569,Ernest Goes to Jail,81,5.4,7766,25029569
1018,10000000,Crime,22424195,The First Power,98,5.7,2847,12424195
1019,0,Biography,2231274,Vincent & Theo,133,7.1,3036,2231274
1020,3000000,Adventure,15369573,Spaced Invaders,100,5.3,2760,12369573
1021,0,Drama,2268181,Texasville,123,6.0,2071,2268181
1022,0,Crime,2678414,"After Dark, My Sweet",114,6.6,2695,2678414
1023,0,Action,8533973,Ski Patrol,91,5.4,2899,8533973
1024,350000,Comedy,1242995,Slumber Party Massacre III,87,4.4,1781,892995
1025,0,Drama,4562778,Graffiti Bridge,95,4.3,1462,4562778
1026,0,Comedy,449868,Side Out,100,5.5,1514,449868
1027,0,Animation,10900000,Jetsons: The Movie,82,5.5,3913,10900000
1028,0,Drama,6070725,Men Don't Leave,115,6.7,2077,6070725
1029,0,Drama,5575738,Europa Europa,112,7.7,12706,5575738
1030,0,Comedy,10959015,Nuns on the Run,89,5.9,6610,10959015
1031,15000000,Action,5585154,Loose Cannons,94,4.8,3785,-9414846
1032,0,Drama,20240128,Stella,109,6.0,2013,20240128
1033,0,Drama,1823154,The Forbidden Dance,97,3.4,1340,1823154
1034,0,Drama,7698010,Mr. & Mrs. Bridge,126,6.7,2427,7698010
1035,0,Comedy,21036771,Madhouse,90,5.3,2370,21036771
1036,0,Drama,4803039,The Long Walk Home,97,7.3,2789,4803039
1037,0,Drama,1030938,Hidden Agenda,108,7.0,2832,1030938
1038,0,Comedy,1382259,Book of Love,100,6.1,893,1382259
1039,0,Comedy,19740070,Betsy's Wedding,94,5.6,2976,19740070
1040,0,Comedy,715983,Coupe de Ville,99,6.7,1927,715983
1041,0,Comedy,3417056,A Shock to the System,88,6.7,3330,3417056
1042,0,Comedy,8141292,Funny About Love,101,4.9,1033,8141292
1043,0,Comedy,17854930,Sibling Rivalry,87,5.4,2115,17854930
1044,6500000,Fantasy,2032973,Gate 2: The Trespassers,90,4.7,1308,-4467027
1045,11500000,Drama,334748,Roger Corman's Frankenstein Unbound,85,5.5,3088,-11165252
1046,0,Drama,1745470,Everybody's Fine,118,7.8,2821,1745470
1047,0,Drama,847306,Come See the Paradise,138,6.7,2198,847306
1048,5000000,Comedy,485772,Meet the Applegates,90,5.4,1819,-4514228
1049,0,Comedy,458996,The Shrimp on the Barbie,90,5.6,985,458996
1050,0,Action,1471,Boiling Point,96,6.8,4920,1471
1051,0,Animation,1781694,El príncipe Cascanueces,100,6.9,1698,1781694
1052,0,Drama,2415312,Body Chemistry,84,4.4,332,2415312
1053,242000,Fantasy,233150,Soultaker,94,2.3,3359,-8850
1054,0,Drama,774048,Mindwalk,112,7.6,2484,774048
1055,0,Comedy,1106475,Where the Heart Is,107,6.2,1333,1106475
1056,0,Crime,59227,Crossing the Line,116,5.8,881,59227
1057,0,Comedy,11359129,Opportunity Knocks,103,6.0,2385,11359129
1058,0,Horror,2218579,Def by Temptation,95,4.4,959,2218579
1059,0,Action,1510053,Streets,100,6.0,564,1510053
1060,0,Comedy,1794001,Tune in Tomorrow...,107,6.2,1518,1794001
1061,0,Drama,1986433,Ju Dou,95,7.8,6221,1986433
1062,0,Comedy,2281569,The Nasty Girl,100,7.5,2133,2281569
1063,0,Family,1393610,Courage Mountain,100,5.8,605,1393610
1064,10000000,Action,2346150,Downtown,96,5.7,1508,-7653850
1065,0,Drama,1305887,The Fourth War,91,5.7,1084,1305887
1066,0,Drama,1161135,To Sleep with Anger,102,7.2,868,1161135
1067,0,Horror,1547867,The Haunting of Morella,82,3.9,543,1547867
1068,0,Crime,2544504,Impulse,109,5.7,969,2544504
1069,0,Comedy,4010647,Short Time,97,6.4,1667,4010647
1070,0,Adventure,1477071,My Mother's Castle,98,7.6,4012,1477071
1071,0,Drama,1224605,Vital Signs,100,5.4,604,1224605
1072,0,Drama,1372350,Everybody Wins,97,5.0,892,1372350
1073,0,Comedy,299090,"¡Ay, Carmela!",102,7.2,1831,299090
1074,0,Drama,1464242,Mister Johnson,101,6.5,740,1464242
1075,0,Comedy,1436308,Love at Large,97,5.8,967,1436308
1076,0,Biography,4212828,China Cry: A True Story,101,7.0,429,4212828
1077,0,Crime,10468,Love & Murder,87,4.4,27,10468
1078,0,Drama,152982,A Show of Force,95,5.2,584,152982
1079,0,Comedy,201332,A Tale of Springtime,108,7.4,2643,201332
1080,0,Drama,805462,C'est la vie,110,6.3,512,805462
1081,0,Comedy,1576702,May Fools,100,7.2,2071,1576702
1082,0,Comedy,113014,The Misadventures of Mr. Wilt,92,6.3,806,113014
1083,0,Adventure,1710856,My Father's Glory,105,7.6,5179,1710856
1084,0,Comedy,604624,Auntie Danielle,100,7.3,2759,604624
1085,0,Comedy,1373728,Daddy's Dyin'... Who's Got the Will?,95,5.8,651,1373728
1086,0,Drama,261718,Journey of Hope,100,7.6,1512,261718
1087,0,Action,410880,Ultra Warrior,100,1.6,661,410880
1088,0,Action,855810,Angel Town,102,5.0,425,855810
1089,0,Comedy,808690,Waiting for the Light,94,6.0,340,808690
1090,0,Action,1531489,The Last of the Finest,106,5.7,879,1531489
1091,0,Comedy,33308,Archangel,90,6.8,1001,33308
1092,0,Drama,139155,Men of Respect,113,5.3,660,139155
1093,0,Comedy,541626,Strike It Rich,87,5.1,125,541626
1094,42000000,Action,307775,Heaven and Earth,104,7.1,792,-41692225
1095,0,Drama,52148,"I, the Worst of All",105,7.1,504,52148
1096,0,Drama,115983,The End of Innocence,100,5.6,139,115983
1097,0,Comedy,169410,Taxi Blues,110,7.5,1276,169410
1098,0,Action,610402,The Return of Superfly,95,5.0,232,610402
1099,0,Crime,85395,Chicago Joe and the Showgirl,103,4.9,587,85395
1100,19000000,Crime,130742922,The Silence of the Lambs,118,8.6,990212,111742922
1101,102000000,Action,204843350,Terminator 2: Judgment Day,137,8.5,813779,102843350
1102,25000000,Animation,218967620,Beauty and the Beast,84,8.0,344844,193967620
1103,6500000,Crime,57504069,Boyz n the Hood,112,7.8,102317,51004069
1104,30000000,Comedy,113502000,The Addams Family,99,6.8,104334,83502000
1105,11000000,Drama,82418501,Fried Green Tomatoes,130,7.7,55887,71418501
1106,70000000,Adventure,119654823,Hook,142,6.7,196513,49654823
1107,24000000,Action,43218387,Punto de quiebra,122,7.2,124027,19218387
1108,16500000,Adventure,45361000,Thelma & Louise,130,7.4,109801,28861000
1109,35000000,Crime,79100000,Cape Fear,128,7.3,138370,44100000
1110,17000000,Comedy,59847242,My Girl,102,6.8,60391,42847242
1111,48000000,Action,165500000,Robin Hood: Prince of Thieves,143,6.9,154125,117500000
1112,0,Comedy,14919570,The Commitments,118,7.6,27784,14919570
1113,13000000,Action,14960255,Child's Play 3,90,5.0,27550,1960255
1114,11000000,Adventure,2807854,Return to the Blue Lagoon,102,5.1,15262,-8192146
1115,30000000,Action,74888996,Star Trek VI: The Undiscovered Country,113,7.2,59567,44888996
1116,40000000,Drama,70405498,JFK,189,8.0,121533,30405498
1117,9000000,Comedy,6153939,Barton Fink,116,7.7,96089,-2846061
1118,35000000,Action,46704056,The Rocketeer,108,6.4,45621,11704056
1119,16000000,Drama,2541541,Naked Lunch,115,7.1,39143,-13458459
1120,0,Comedy,89325780,Father of the Bride,105,6.5,58569,89325780
1121,26000000,Action,69467617,Hot Shots!,84,6.7,85058,43467617
1122,40000000,Comedy,8479793,Nothing But Trouble,94,4.9,18672,-31520207
1123,0,Comedy,1794187,Delicatessen,99,7.7,70220,1794187
1124,15000000,Comedy,25104700,Problem Child 2,93,4.6,17894,10104700
1125,35000000,Comedy,63710000,What About Bob?,99,7.0,53791,28710000
1126,2500000,Drama,6401336,My Own Private Idaho,104,7.1,40101,3901336
1127,27000000,Comedy,124033791,City Slickers,113,6.7,41443,97033791
1128,38000000,Biography,35183792,The Doors,140,7.2,72491,-2816208
1129,24000000,Comedy,41895491,The Fisher King,137,7.6,67814,17895491
1130,29000000,Action,59509925,The Last Boy Scout,105,6.9,80307,30509925
1131,75000000,Action,77868585,Backdraft,137,6.7,61711,2868585
1132,19000000,Drama,101599005,Sleeping with the Enemy,99,6.2,40443,82599005
1133,0,Comedy,25196249,Don't Tell Mom the Babysitter's Dead,102,6.1,23117,25196249
1134,6000000,Comedy,24204154,The People Under the Stairs,102,6.3,25742,18204154
1135,0,Drama,2853801,The Man in the Moon,99,7.4,12973,2853801
1136,10000000,Action,15073942,Toy Soldiers,111,6.5,17063,5073942
1137,8500000,Action,47624253,New Jack City,97,6.6,25867,39124253
1138,25000000,Action,78656813,Teenage Mutant Ninja Turtles II: The Secret of the Ooze,88,6.0,44901,53656813
1139,11000000,Comedy,34872033,Freddy's Dead: The Final Nightmare,89,4.9,33582,23872033
1140,65000000,Action,17218080,Hudson Hawk,100,5.8,45642,-47781920
1141,0,Comedy,11336986,Career Opportunities,83,5.9,7577,11336986
1142,20000000,Adventure,38037513,Bill & Ted's Bogus Journey,93,6.2,52853,18037513
1143,6788000,Comedy,43878334,Drop Dead Fred,103,5.8,23181,37090334
1144,15000000,Action,30102717,Double Impact,110,5.5,31574,15102717
1145,3500000,Comedy,2015810,Night on Earth,129,7.8,44688,-1484190
1146,13500000,Comedy,26255594,Necessary Roughness,108,6.1,8750,12755594
1147,29000000,Comedy,22773535,Frankie and Johnny,118,6.7,24326,-6226465
1148,35000000,Comedy,23562716,Oscar,109,6.4,25116,-11437284
1149,0,Comedy,14143280,Ernest Scared Stupid,91,5.7,9139,14143280
1150,0,Animation,22166041,An American Tail: Fievel Goes West,75,6.5,18924,22166041
1151,30000000,Biography,49114016,Bugsy,136,6.8,22209,19114016
1152,30000000,Drama,74787599,The Prince of Tides,132,6.7,13391,44787599
1153,23000000,Comedy,86930411,The Naked Gun 2½: The Smell of Fear,85,6.8,89142,63930411
1154,14000000,Action,39673161,Out for Justice,91,6.0,18164,25673161
1155,0,Drama,8750400,The Five Heartbeats,121,7.5,2927,8750400
1156,14000000,Drama,32482682,Jungle Fever,132,6.5,14307,18482682
1157,6000000,Comedy,1193062,Cool as Ice,91,2.8,7942,-4806938
1158,0,Thriller,28738096,Deceived,104,6.1,5305,28738096
1159,50000000,Drama,43001500,Regarding Henry,108,6.7,24971,-6998500
1160,8000000,Action,2275557,Showdown in Little Tokyo,79,6.1,13465,-5724443
1161,0,Drama,1999955,The Double Life of Veronique,98,7.9,31728,1999955
1162,17000000,Action,7241350,Rush,120,6.7,6699,-9758650
1163,15000000,Crime,38016380,Dead Again,107,7.0,22783,23016380
1164,23000,Comedy,1228108,Slacker,97,7.1,16396,1205108
1165,30000000,Action,15556340,Highlander II: The Quickening,91,4.1,38557,-14443660
1166,0,Comedy,16371128,Defending Your Life,112,7.3,14509,16371128
1167,0,Comedy,54830779,Doc Hollywood,104,6.1,27679,54830779
1168,25000000,Comedy,33691313,Curly Sue,101,5.7,17739,8691313
1169,18000000,Animation,11657385,Amigos inseparables,100,6.0,6716,-6342615
1170,23000000,Action,7434726,Harley Davidson and the Marlboro Man,98,6.0,15567,-15565274
1171,14000000,Adventure,34793160,White Fang,107,6.7,16702,20793160
1172,0,Drama,33669178,Dying Young,111,5.9,12581,33669178
1173,0,Action,7788597,If Looks Could Kill,88,5.7,5551,7788597
1174,23000000,Crime,20246790,Mobsters,104,5.9,7229,-2753210
1175,0,Crime,221295,Under Suspicion,99,6.5,2752,221295
1176,0,Action,21760000,Ricochet,102,6.1,13505,21760000
1177,0,Drama,14789113,Not Without My Daughter,116,6.2,10368,14789113
1178,17000000,Action,9286314,Stone Cold,88,5.9,5551,-7713686
1179,0,Comedy,28862081,L.A. Story,95,6.7,26346,28862081
1180,0,Drama,7300000,Wild Hearts Can't Be Broken,88,7.2,4092,7300000
1181,0,Drama,1008404,Whore,85,5.5,2921,1008404
1182,0,Comedy,15545943,Switch,103,5.7,7160,15545943
1183,0,Drama,2415396,Flirting,99,7.3,5046,2415396
1184,0,Animation,415941,Only Yesterday,118,7.7,16144,415941
1185,0,Action,6948859,Suburban Commando,90,4.3,8055,6948859
1186,17000000,Comedy,2865916,Another You,100,5.3,2959,-14134084
1187,10000000,Drama,25010896,Little Man Tate,99,6.7,12172,15010896
1188,0,Drama,135893,Close My Eyes,108,6.4,2538,135893
1189,0,Comedy,34002045,King Ralph,97,5.2,13317,34002045
1190,23000000,Action,752856,Until the End of the World,280,6.8,7344,-22247144
1191,1400000,Comedy,115103,Shakes the Clown,87,5.6,3958,-1284897
1192,0,Comedy,4205000,Popcorn,91,5.7,2785,4205000
1193,8000000,Mystery,19018321,Mortal Thoughts,102,5.7,7239,11018321
1194,0,Action,25895485,The Hard Way,111,6.3,15517,25895485
1195,0,Drama,408571,La bella latosa,238,7.8,5123,408571
1196,0,Drama,7310000,Mississippi Masala,118,6.6,4116,7310000
1197,0,Comedy,394631,Dogfight,94,7.5,6927,394631
1198,0,Drama,2603061,Raise the Red Lantern,125,8.2,22684,2603061
1199,10000000,Horror,9188150,Body Parts,88,5.5,3290,-811850
1200,22000000,Crime,11511031,Shattered,98,6.5,6807,-10488969
1201,0,Drama,1007001,Europa,112,7.7,16870,1007001
1202,13000000,Comedy,4102526,Life Stinks,92,5.8,7979,-8897474
1203,18000000,Comedy,5546827,Delirious,96,5.7,6370,-12453173
1204,7000000,Drama,191125,The Indian Runner,127,7.1,7239,-6808875
1205,11000000,Drama,1059071,Kafka,98,6.9,8341,-9940929
1206,0,Comedy,36489888,Soapdish,97,6.5,12336,36489888
1207,0,Drama,38120905,The Doctor,122,6.9,4314,38120905
1208,0,Adventure,8211952,Black Robe,101,7.1,5638,8211952
1209,17000000,Comedy,4603929,Dutch,107,6.4,10048,-12396071
1210,48000000,Crime,15965919,Billy Bathgate,106,5.9,10085,-32034081
1211,0,Comedy,1710057,High Heels,112,7.2,10971,1710057
1212,0,Comedy,9804775,"He Said, She Said",115,5.6,5289,9804775
1213,3000000,Crime,390152,Where the Day Takes You,105,6.8,2522,-2609848
1214,8000000,Comedy,10438504,A Rage in Harlem,100,5.9,1581,2438504
1215,0,Comedy,21830957,Only the Lonely,104,6.3,8491,21830957
1216,7500000,Drama,6266621,Rambling Rose,112,6.7,4115,-1233379
1217,0,Crime,33243020,Grand Canyon,134,6.9,13271,33243020
1218,0,Comedy,14812000,All I Want for Christmas,92,6.0,3508,14812000
1219,0,Action,10440032,Armour of God 2: Operation Condor,106,7.3,15147,10440032
1220,13000000,Comedy,3752426,Mannequin: On the Move,95,4.1,4885,-9247574
1221,10000000,Action,14061361,The Perfect Weapon,90,6.0,2867,4061361
1222,18000000,Action,1501785,Company Business,98,5.7,1996,-16498215
1223,0,Drama,1277401,The Rapture,100,6.4,4296,1277401
1224,35000000,Action,14587732,Flight of the Intruder,115,5.7,5162,-20412268
1225,40000000,Comedy,17860280,For the Boys,138,6.3,4430,-22139720
1226,0,Action,1250712,Kickboxer 2: The Road Back,100,4.5,4588,1250712
1227,14000000,Comedy,2735731,Shadows and Fog,85,6.8,14024,-11264269
1228,2000000,Horror,3331,The Pit and the Pendulum,97,6.1,3241,-1996669
1229,5000000,Comedy,19281235,House Party 2,100,5.1,3925,14281235
1230,0,Drama,1750301,Prospero's Books,124,6.9,5335,1750301
1231,0,Drama,9480198,Guilty by Suspicion,105,6.5,6588,9480198
1232,36000000,Drama,1342903,At Play in the Fields of the Lord,189,6.8,2755,-34657097
1233,0,Drama,418807,True Colors,111,6.3,4205,418807
1234,26000000,Comedy,12454768,The Marrying Man,115,5.7,4445,-13545232
1235,17010000,Comedy,22641969,Pure Luck,96,5.7,5618,5631969
1236,22000000,Comedy,11000863,The Super,84,5.5,4400,-10999137
1237,0,Comedy,9689816,The Butcher's Wife,107,5.3,5723,9689816
1238,16400000,Action,21082165,F/X2,108,5.8,7248,4682165
1239,28000000,Drama,117569,The Lovers on the Bridge,125,7.6,9590,-27882431
1240,0,Action,3106559,K2,102,6.2,5614,3106559
1241,250000,Drama,609524,Poison,85,6.5,2724,359524
1242,0,Drama,24277858,Class Action,110,6.4,5499,24277858
1243,0,Drama,13200170,Enchanted April,95,7.4,5334,13200170
1244,16000000,Action,4409328,Run,91,6.1,2157,-11590672
1245,0,Drama,3547684,Shout,89,5.0,1594,3547684
1246,0,Crime,15429177,A Kiss Before Dying,94,5.7,4042,15429177
1247,0,Comedy,25682090,Other People's Money,103,6.1,6905,25682090
1248,0,Horror,2368,Scissors,100,5.2,2057,2368
1249,0,Drama,1642436,Daughters of the Dust,100,6.5,1135,1642436
1250,4000000,Action,11276846,One Good Cop,114,5.8,3226,7276846
1251,0,Adventure,396003,Sex and Zen,100,5.8,1687,396003
1252,0,Biography,4076211,Impromptu,107,7.0,4064,4076211
1253,0,Action,4654288,The Hitman,95,5.3,2836,4654288
1254,0,Animation,2144238,The Princess and the Goblin,100,6.9,1975,2144238
1255,0,Drama,516431,Rapsodia en agosto,98,7.3,5202,516431
1256,0,Drama,573904,Wild Orchid II: Two Shades of Blue,111,3.7,1253,573904
1257,16000000,Comedy,14851083,Once Around,115,6.5,3594,-1148917
1258,0,Comedy,295444,Riff-Raff,95,7.1,3324,295444
1259,0,Drama,1942424,Madame Bovary,143,6.7,3041,1942424
1260,0,Drama,524668,Proof,86,7.4,5369,524668
1261,0,Crime,2971661,Homicide,102,7.1,5024,2971661
1262,0,Comedy,7683267,Strictly Business,100,5.4,1507,7683267
1263,0,Comedy,4532791,Mediterraneo,96,7.4,11479,4532791
1264,0,Comedy,574392,Johnny Stecchino,102,7.2,8466,574392
1265,0,Drama,694438,Edward II,87,7.0,1997,694438
1266,6000000,Action,869325,Beastmaster 2: Through the Portal of Time,107,3.8,2462,-5130675
1267,0,Action,11128309,V.I. Warshawski,89,4.8,4135,11128309
1268,0,Action,1182273,Year of the Gun,111,5.7,1977,1182273
1269,0,Drama,516517,Voyager,117,6.8,2507,516517
1270,0,Comedy,9074,Sólo con tu pareja,94,7.1,2423,9074
1271,0,Comedy,396573,The Adjuster,102,6.7,2727,396573
1272,10000000,Comedy,6166819,Mystery Date,97,6.0,2180,-3833181
1273,0,Comedy,242014,Stepping Out,106,6.4,903,242014
1274,0,Action,456127,McBain,107,4.7,1284,456127
1275,4000000,Drama,259012,Closet Land,100,7.2,2293,-3740988
1276,10000000,Adventure,8667684,Bingo,100,4.7,2380,-1332316
1277,0,Drama,1403033,Where Angels Fear to Tread,100,6.6,1691,1403033
1278,0,Biography,138720,Van Gogh,158,7.3,2069,138720
1279,0,Comedy,2120564,29th Street,101,7.3,2157,2120564
1280,0,Biography,218316,Becoming Colette,100,5.4,192,218316
1281,19000000,Action,939277,The Taking of Beverly Hills,96,4.9,869,-18060723
1282,0,Comedy,1228153,Toto the Hero,91,7.7,4546,1228153
1283,1900000,Comedy,532933,Hangin' with the Homeboys,100,7.0,1147,-1367067
1284,0,Drama,18634643,Paradise,111,6.7,2375,18634643
1285,0,Adventure,789127,Cabeza de Vaca,100,7.0,883,789127
1286,0,Drama,583979,The Inner Circle,137,7.1,1676,583979
1287,0,Mystery,133645,Liebestraum,112,6.0,1320,133645
1288,0,Comedy,5186392,The Object of Beauty,103,5.7,1660,5186392
1289,0,Drama,31000,Crooked Hearts,113,6.1,761,31000
1290,0,Drama,8906823,Late for Dinner,99,6.5,1474,8906823
1291,450000,Crime,2712293,Straight Out of Brooklyn,100,5.9,499,2262293
1292,0,Comedy,25480000,Mon Pere Ce Heros,105,6.1,2224,25480000
1293,0,Comedy,978775,Talkin' Dirty After Dark,89,5.2,425,978775
1294,0,Crime,1407309,Lovers: A True Story,103,7.2,1875,1407309
1295,0,Drama,1159578,The Unborn,100,4.0,780,1159578
1296,0,Comedy,5467959,Livin' Large!,100,5.0,374,5467959
1297,0,Biography,3089497,Tous les matins du monde,115,7.6,5433,3089497
1298,0,Romance,717772,Thousand Pieces of Gold,105,7.1,460,717772
1299,0,Comedy,402539,And You Thought Your Parents Were Weird,92,4.5,393,402539
1300,0,Comedy,612781,Queens Logic,100,5.9,1343,612781
1301,3000000,Comedy,9563393,Scenes from a Mall,89,5.3,4158,6563393
1302,0,Drama,3603615,My Heroes Have Always Been Cowboys,100,6.4,413,3603615
1303,0,Drama,336396,Talent for the Game,91,5.9,624,336396
1304,3000000,Crime,1264910,City of Hope,129,7.4,1889,-1735090
1305,0,Drama,256521,Twenty-One,92,5.3,429,256521
1306,0,Comedy,4313173,Hear My Song,100,7.2,1338,4313173
1307,13000000,Action,5451119,Eve of Destruction,99,4.8,1664,-7548881
1308,6000000,Action,64562,Timebomb,96,5.5,1236,-5935438
1309,14000000,Comedy,1989059,Married to It,112,5.9,757,-12010941
1310,0,Mystery,6413375,Defenseless,104,5.8,583,6413375
1311,0,Comedy,170667,London Kills Me,107,6.3,491,170667
1312,15000000,Comedy,4693236,True Identity,93,5.1,1019,-10306764
1313,0,Comedy,184890,The Ballad of the Sad Cafe,100,6.5,547,184890
1314,0,Comedy,291645,Highway 61,102,7.2,1210,291645
1315,0,Drama,356825,The Knife,104,6.2,510,356825
1316,0,Comedy,582510,The Pope Must Diet,100,5.0,1304,582510
1317,0,Comedy,1000348,Meeting Venus,119,6.8,1060,1000348
1318,0,Comedy,306319,Hard Promises,95,5.8,450,306319
1319,0,Comedy,1076,Samantha,96,6.5,330,1076
1320,1200000,Crime,2832029,Reservoir Dogs,99,8.3,735396,1632029
1321,40000000,Horror,82522790,Bram Stoker's Dracula,128,7.5,155460,42522790
1322,28000000,Animation,217350219,Aladdin,90,8.0,287068,189350219
1323,80000000,Action,162831698,Batman Returns,126,7.0,232027,82831698
1324,49000000,Drama,117727000,Bajos instintos,127,6.9,143903,68727000
1325,40000000,Action,75505856,The Last of the Mohicans,112,7.8,122987,35505856
1326,14400000,Drama,101157447,Unforgiven,131,8.2,304536,86757447
1327,11000000,Comedy,52929168,My Cousin Vinny,120,7.5,88685,41929168
1328,40000000,Drama,141340178,A Few Good Men,138,7.7,196002,101340178
1329,10000000,Drama,4160851,Twin Peaks: Fire Walk with Me,135,7.2,67092,-5839149
1330,50000000,Action,55473600,Alien 3,114,6.4,231709,5473600
1331,31000000,Comedy,139610000,Sister Act,100,6.3,70833,108610000
1332,40000000,Comedy,107533928,A League of Their Own,128,7.2,77047,67533928
1333,55000000,Comedy,58422650,Death Becomes Her,104,6.5,85470,3422650
1334,31000000,Drama,63895607,Scent of a Woman,156,8.0,209862,32895607
1335,15000000,Drama,2819485,Newsies,121,7.0,16383,-12180515
1336,25000000,Action,121945720,The Bodyguard,129,6.2,97795,96945720
1337,20000000,Comedy,121697350,Wayne's World,94,7.0,122552,101697350
1338,10000000,Comedy,50752337,The Mighty Ducks,100,6.4,48129,40752337
1339,11000000,Comedy,11502976,Army of Darkness,81,7.6,139216,502976
1340,18000000,Adventure,173585516,Home Alone 2: Lost in New York,120,6.6,226766,155585516
1341,35000000,Action,83363139,Under Siege,103,6.5,65431,48363139
1342,12500000,Crime,10725228,Glengarry Glen Ross,100,7.8,82352,-1774772
1343,3000000,Comedy,242623,Dead Alive,104,7.6,81752,-2757377
1344,6000000,Horror,25792310,Candyman,99,6.6,54076,19792310
1345,45000000,Action,83287363,Patriot Games,117,6.9,86479,38287363
1346,0,Drama,14715067,School Ties,106,6.9,19216,14715067
1347,0,Drama,5101632,Of Mice and Men,115,7.5,34253,5101632
1348,24000000,Adventure,22518097,Captain Ron,90,5.7,17877,-1481903
1349,0,Drama,43440294,A River Runs Through It,123,7.3,44727,43440294
1350,31000000,Biography,9493259,Chaplin,143,7.6,45964,-21506741
1351,33000000,Biography,48169908,Malcolm X,202,7.7,69074,15169908
1352,15000000,Horror,30524763,Sleepwalkers,91,5.2,16241,15524763
1353,24000000,Animation,24650296,FernGully: Las aventuras de Zak y Crysta,76,6.5,22480,650296
1354,0,Comedy,57114049,Beethoven,87,5.6,54142,57114049
1355,5000000,Horror,12534961,Hellraiser III: Hell on Earth,91,5.5,22036,7534961
1356,0,Crime,62549000,The Crying Game,112,7.3,44049,62549000
1357,7000000,Action,16624456,Buffy the Vampire Slayer,86,5.6,34181,9624456
1358,8000000,Fantasy,17092453,Pet Sematary II,100,4.8,14545,9092453
1359,0,Comedy,18472850,Singles,99,6.7,24175,18472850
1360,23000000,Action,36299898,Universal Soldier,102,6.0,72711,13299898
1361,0,Comedy,76253806,White Men Can't Jump,115,6.7,62938,76253806
1362,0,Comedy,938473,"Jamón, Jamón",95,6.5,10092,938473
1363,7000000,Comedy,40693477,Encino Man,88,5.7,31980,33693477
1364,5000000,Action,20146880,Juice,95,7.1,18787,15146880
1365,0,Biography,4899194,The Lover,115,6.9,16103,4899194
1366,60000000,Adventure,58883840,Far and Away,140,6.5,50869,-1116160
1367,35000000,Action,144731527,Lethal Weapon 3,118,6.7,136206,109731527
1368,5000000,Drama,1862805,Luna amarga,139,7.2,28002,-3137195
1369,10000000,Horror,32101000,The Lawnmower Man,108,5.4,29522,22101000
1370,3000000,Drama,1829804,Poison Ivy,88,5.4,14751,-1170196
1371,11700000,Drama,88036683,The Hand That Rocks the Cradle,110,6.6,31853,76336683
1372,0,Comedy,14796494,Ladybugs,90,5.3,7236,14796494
1373,16000000,Drama,47922919,Single White Female,107,6.3,25871,31922919
1374,1000000,Crime,2000022,Bad Lieutenant,96,7.1,31763,1000022
1375,6500000,Action,29000301,3 Ninjas,84,5.2,17402,22500301
1376,35000000,Comedy,51433000,Sneakers,126,7.1,46109,16433000
1377,40000000,Comedy,70100000,Boomerang,117,5.4,21723,30100000
1378,8000000,Comedy,21706100,The Player,124,7.6,45208,13706100
1379,43000000,Adventure,21452082,Toys,118,5.0,27750,-21547918
1380,47000000,Adventure,7191399,1492: Conquista del Paraíso,154,6.5,24155,-39808601
1381,0,Comedy,205569,Man Bites Dog,95,7.6,30524,205569
1382,35000000,Biography,24276500,Hoffa,140,6.6,18198,-10723500
1383,15000000,Action,44065653,Passenger 57,84,5.8,39076,29065653
1384,0,Drama,25967000,Howards End,140,7.5,22936,25967000
1385,2000000,Drama,21665500,Como agua para chocolate,105,7.2,14517,19665500
1386,0,Crime,175340,Romper Stomper,94,6.8,33340,175340
1387,0,Drama,7532911,Damage,111,6.9,13297,7532911
1388,7000,Action,2040920,El Mariachi,81,6.9,55226,2033920
1389,0,Comedy,11738022,Strictly Ballroom,94,7.2,21634,11738022
1390,0,Action,4972818,Innocent Blood,112,6.2,7833,4972818
1391,16000000,Biography,13086430,American Me,125,7.2,6417,-2913570
1392,30000000,Animation,14110600,Cool World,102,4.8,17780,-15889400
1393,40000000,Adventure,58662452,Honey I Blew Up the Kid,89,4.7,34421,18662452
1394,4000000,Biography,5289772,Orlando,94,7.2,10849,1289772
1395,0,Drama,55956200,Forever Young,102,6.3,38863,55956200
1396,0,Drama,25105517,The Cutting Edge,101,6.9,16022,25105517
1397,35000000,Drama,4651977,Radio Flyer,114,6.9,10947,-30348023
1398,8000000,Action,6739141,Fortress,95,5.9,24573,-1260859
1399,14000000,Adventure,2034470,Mom and Dad Save the World,88,5.3,3656,-11965530
1400,0,Drama,15164458,Pure Country,112,6.9,3075,15164458
1401,12000000,Crime,21370057,Raising Cain,91,6.0,10992,9370057
1402,3500000,Animation,3560469,The Tom and Jerry Movie,84,5.3,7519,60469
1403,0,Action,17180393,Sidekicks,101,4.9,6775,17180393
1404,0,Crime,12282994,A Stranger Among Us,110,5.7,2947,12282994
1405,0,Drama,2827107,The Power of One,127,7.2,7949,2827107
1406,0,Crime,57138719,Unlawful Entry,117,6.3,11981,57138719
1407,40000000,Adventure,45500797,Medicine Man,106,6.0,18461,5500797
1408,0,Adventure,10736401,Stay Tuned,88,6.1,8697,10736401
1409,30000000,Drama,7286388,Lorenzo's Oil,129,7.2,17514,-22713612
1410,7000000,Action,5430822,Split Second,90,6.2,9103,-1569178
1411,18000000,Crime,21591728,Consenting Adults,99,5.7,5783,3591728
1412,0,Crime,3052738,CrissCross,100,5.8,1383,3052738
1413,10000000,Action,14356479,Rapid Fire,95,6.3,6784,4356479
1414,12000000,Comedy,2280148,Noises Off...,101,7.5,8745,-9719852
1415,42000000,Comedy,19507345,Hero,119,6.5,18627,-22492655
1416,27000000,Drama,14683921,City of Joy,132,6.4,4193,-12316079
1417,900000,Action,16270600,Supercop,95,6.9,16056,15370600
1418,15000000,Crime,22660758,Thunderheart,119,6.8,12056,7660758
1419,25000000,Comedy,35208854,Honeymoon in Vegas,96,5.8,15079,10208854
1420,12000000,Comedy,27281507,The Muppet Christmas Carol,85,7.7,37054,15281507
1421,900000,Horror,6980986,Children of the Corn II: The Final Sacrifice,92,4.2,6311,6080986
1422,45000000,Action,28411210,Stop! Or My Mom Will Shoot,87,4.1,33574,-16588790
1423,5000000,Comedy,4058564,Peter's Friends,101,7.0,9009,-941436
1424,0,Biography,17530973,The Babe,100,5.9,8040,17530973
1425,0,Comedy,754935,Love Potion No. 9,92,5.6,11082,754935
1426,14000000,Action,13747138,Trespass,101,6.2,8433,-252862
1427,20000000,Comedy,10555619,Husbands and Wives,103,7.6,23108,-9444381
1428,0,Crime,1543112,One False Move,105,7.2,8085,1543112
1429,20000000,Crime,11390479,Jennifer 8,124,6.2,12992,-8609521
1430,0,Action,9223441,Gladiator,101,6.4,7094,9223441
1431,40000000,Comedy,14358033,Memoirs of an Invisible Man,99,5.9,18652,-25641967
1432,15000000,Action,40227000,Mo' Money,89,5.4,5876,25227000
1433,0,Comedy,8403433,Dr. Giggles,95,5.1,4705,8403433
1434,0,Comedy,58500635,HouseSitter,102,6.0,18396,58500635
1435,7500000,Comedy,13272113,Class Act,98,6.0,4351,5772113
1436,0,Action,21142815,Kuffs,102,5.8,8420,21142815
1437,4000000,Crime,1373196,South Central,99,6.8,3841,-2626804
1438,32000000,Drama,28590665,Final Analysis,124,5.8,11503,-3409335
1439,15500000,Drama,6742168,The Mambo Kings,104,6.4,4469,-8757832
1440,0,Drama,5734232,Indochine,148,7.1,7851,5734232
1441,30000000,Action,17129000,Freejack,110,5.3,12883,-12871000
1442,0,Drama,21733781,Shining Through,132,6.4,7877,21733781
1443,0,Action,16639799,Deep Cover,107,6.9,7163,16639799
1444,0,Drama,20194,That Night,89,6.7,1798,20194
1445,0,Comedy,5971369,Belle Epoque,109,7.2,7915,5971369
1446,50000000,Comedy,46666502,The Distinguished Gentleman,112,5.9,13167,-3333498
1447,40000000,Adventure,8251071,Christopher Columbus: The Discovery,120,4.4,2418,-31748929
1448,0,Action,2001124,Nemesis,95,5.6,3987,2001124
1449,10000000,Action,8332431,Twin Dragons,104,6.4,9292,-1667569
1450,0,Comedy,23369283,Leap of Faith,108,6.1,10455,23369283
1451,17000000,Drama,4836637,Diggstown,98,7.0,6006,-12163363
1452,0,Comedy,4479470,Bob Roberts,102,7.0,12074,4479470
1453,0,Comedy,271327,Big Girls Don't Cry... They Get Even,96,6.5,1493,271327
1454,5000000,Drama,1526697,A Midnight Clear,108,7.2,7365,-3473303
1455,0,Drama,277813,Tokyo Decadence,135,6.1,2276,277813
1456,29000000,Action,5519569,Wind,126,6.5,2123,-23480431
1457,18000000,Drama,1949148,Love Field,105,6.7,3099,-16050852
1458,0,Action,9011574,White Sands,101,6.0,5881,9011574
1459,0,Adventure,4790801,Into the West,100,7.0,2324,4790801
1460,40000000,Comedy,20883046,Mr. Baseball,108,5.9,8610,-19116954
1461,0,Drama,1345236,"Gas, Food Lodging",101,6.7,2888,1345236
1462,0,Drama,386329,For a Lost Soldier,92,7.6,3840,386329
1463,20000000,Comedy,6202756,Night and the City,105,5.8,3900,-13797244
1464,0,Comedy,21202099,Straight Talk,91,5.7,2885,21202099
1465,0,Drama,1468300,Zebrahead,100,6.3,1044,1468300
1466,10000000,Drama,1034287,Waterland,95,6.7,1855,-8965713
1467,0,Drama,4906900,The Playboys,117,6.4,973,4906900
1468,0,Drama,2922094,This Is My Life,100,6.0,929,2922094
1469,5000000,Crime,1050861,Light Sleeper,103,6.9,3999,-3949139
1470,0,Crime,923418,Juego a muerte,108,6.1,6433,923418
1471,0,Animation,8442162,Bébé's Kids,70,5.5,3387,8442162
1472,0,Comedy,20006730,Prelude to a Kiss,105,5.6,6849,20006730
1473,0,Comedy,610488,Léolo,107,7.6,5950,610488
1474,0,Comedy,8669847,Once Upon a Crime...,94,5.8,3150,8669847
1475,0,Comedy,1102469,Mistress,110,5.5,1766,1102469
1476,43000000,Comedy,13351357,Mr. Saturday Night,119,5.8,3990,-29648643
1477,30000000,Comedy,4096030,Man Trouble,100,4.6,2557,-25903970
1478,10000000,Crime,384048,American Heart,113,6.8,2634,-9615952
1479,2700000,Drama,1723319,The Waterdance,106,6.9,2369,-976681
1480,0,Action,2517600,Aces: Iron Eagle III,98,3.5,2424,2517600
1481,0,Romance,2387928,Love Crimes,90,4.1,745,2387928
1482,0,Comedy,6132924,Folks!,107,5.5,2147,6132924
1483,3330000,Drama,5414619,Passion Fish,135,7.5,4448,2084619
1484,0,Comedy,256249,In the Soup,93,7.1,2047,256249
1485,0,Crime,3067917,The Public Eye,99,6.5,2773,3067917
1486,18000000,Drama,6375979,Article 99,100,6.1,2585,-11624021
1487,0,Drama,422503,Storyville,113,5.8,963,422503
1488,0,Comedy,918239,Brain Donors,100,7.1,3491,918239
1489,0,Comedy,101307,The Efficiency Expert,100,6.3,1456,101307
1490,3000000,Crime,141554,Simple Men,105,7.2,3563,-2858446
1491,0,Comedy,1659542,Out on a Limb,100,5.2,1368,1659542
1492,0,Comedy,4030793,Passed Away,96,5.9,1053,4030793
1493,0,Drama,213687,A Tale of Winter,114,7.6,2948,213687
1494,0,Biography,1253106,The Best Intentions,100,7.9,2326,1253106
1495,800000,Crime,114516,Guncrazy,97,5.6,1768,-685484
1496,18000000,Drama,11124511,Whispers in the Dark,103,5.6,1674,-6875489
1497,0,Comedy,288633,House of Angels,127,6.4,3564,288633
1498,0,Horror,2550,Tetsuo II: Body Hammer,83,6.4,3259,2550
1499,400000,Comedy,152322,Pushing Hands,105,7.3,2826,-247678
1500,0,Action,2791515,Year of the Comet,91,5.8,1207,2791515
1501,0,Biography,161179,The Long Day Closes,85,7.5,2003,161179
1502,0,Drama,931280,The Stolen Children,114,7.5,2101,931280
1503,0,Comedy,3104545,Blame It on the Bellboy,78,5.4,2155,3104545
1504,0,Adventure,1448640,Shadow of the Wolf,112,5.7,710,1448640
1505,3000000,Comedy,690966,The Opposite Sex and How to Live with Them,100,4.9,540,-2309034
1506,0,Crime,3206713,Traces of Red,105,5.2,1306,3206713
1507,18000000,Drama,2149735,Rich in Love,100,6.3,689,-15850265
1508,0,Drama,222552,Chain of Desire,100,5.4,360,222552
1509,0,Drama,1666511,Un Coeur en Hiver,105,7.7,7657,1666511
1510,0,Drama,479169,Just Another Girl on the I.R.T.,92,6.3,698,479169
1511,0,Biography,662341,Savage Nights,126,7.1,1921,662341
1512,0,Crime,28422,Rebels of the Neon God,106,7.6,2251,28422
1513,0,Comedy,1514114,Leaving Normal,110,6.7,1217,1514114
1514,22769,Comedy,692585,The Living End,81,6.5,2140,669816
1515,0,Comedy,1890247,The Story of Qiu Ju,101,7.6,4429,1890247
1516,0,Comedy,479676,Crossing the Bridge,103,6.4,681,479676
1517,0,Drama,7306242,Sarafina!,117,6.4,1586,7306242
1518,0,Biography,919286,Ruby,110,5.5,1239,919286
1519,0,Adventure,2806881,Map of the Human Heart,109,7.2,2779,2806881
1520,0,Drama,1256355,"Olivier, Olivier",110,7.7,1462,1256355
1521,0,Action,229041,Fifty/Fifty,101,5.8,550,229041
1522,24000000,Mystery,608866,Ruby Cairo,100,5.0,1886,-23391134
1523,13000000,Comedy,3721911,The Gun in Betty Lou's Handbag,89,5.0,1430,-9278089
1524,16000000,Comedy,17957265,Used People,100,6.0,1225,1957265
1525,0,Thriller,135004,No Place to Hide,100,5.6,505,135004
1526,0,Crime,279627,Equinox,110,5.7,1033,279627
1527,0,Action,198504,Rescue Me,99,5.5,455,198504
1528,0,Action,641886,Into the Sun,101,5.2,664,641886
1529,0,Animation,1119368,Freddie as F.R.O.7.,100,5.1,561,1119368
1530,0,Adventure,147724,Roadside Prophets,100,6.5,1065,147724
1531,0,Drama,100986,A Place in the World,120,7.9,1880,100986
1532,130000,Drama,799674,Claire of the Moon,107,4.9,843,669674
1533,0,Action,28676,Naked Killer,100,6.0,1896,28676
1534,0,Drama,471120,Mac,117,6.3,787,471120
1535,0,Action,2567,Khuda Gawah,193,6.6,1407,2567
1536,0,Comedy,123587,My New Gun,99,5.6,583,123587
1537,0,Comedy,130377,Hold Me Thrill Me Kiss Me,92,6.0,371,130377
1538,250000,Crime,340147,Swoon,93,6.8,1365,90147
1539,38000,Crime,117480,Laws of Gravity,100,7.0,769,79480
1540,28000000,Comedy,39514713,Hocus Pocus,96,6.7,67192,11514713
1541,25000000,Action,56505065,Tombstone,130,7.8,103911,31505065
1542,22000000,Biography,96067179,Schindler's List,195,8.9,956124,74067179
1543,0,Comedy,32416586,The Sandlot,101,7.8,63337,32416586
1544,63000000,Adventure,402453882,Jurassic Park,127,8.1,685270,339453882
1545,18000000,Animation,75082668,The Nightmare Before Christmas,76,8.0,242487,57082668
1546,6900000,Comedy,7993039,Dazed and Confused,102,7.7,133831,1093039
1547,25000000,Crime,40903593,Un día de furia,113,7.6,143906,15903593
1548,42000000,Drama,158348367,The Firm,154,6.8,95562,116348367
1549,13000000,Crime,12281500,True Romance,120,8.0,174471,-718500
1550,75000000,Comedy,48919043,Addams Family Values,94,6.6,62350,-26080957
1551,22000000,Crime,17266971,A Bronx Tale,121,7.8,106183,-4733029
1552,11000000,Drama,9170214,What's Eating Gilbert Grape,118,7.8,183569,-1829786
1553,0,Drama,31181347,The Secret Garden,101,7.3,30896,31181347
1554,14600000,Comedy,70906973,Groundhog Day,101,8.0,483649,56306973
1555,20000000,Adventure,35739755,Robin Hood: Men in Tights,104,6.7,97973,15739755
1556,25000000,Comedy,219200000,Mrs. Doubtfire,125,6.9,198772,194200000
1557,21000000,Comedy,126533006,Sleepless in Seattle,105,6.8,132264,105533006
1558,85000000,Action,50016394,Last Action Hero,130,6.3,114476,-34983606
1559,35000000,Crime,4496583,"Blood In, Blood Out",180,8.0,24686,-30503417
1560,70000000,Action,84049211,Cliffhanger,112,6.4,102888,14049211
1561,44000000,Action,183875760,The Fugitive,130,7.8,226899,139875760
1562,20000000,Adventure,77698625,Free Willy,112,5.9,56085,57698625
1563,38000000,Drama,106614100,Indecent Proposal,117,5.8,51687,68614100
1564,26000000,Drama,77324422,Philadelphia,125,7.7,191244,51324422
1565,0,Adventure,41833324,Homeward Bound: The Incredible Journey,84,6.9,36081,41833324
1566,7000000,Drama,40158000,El piano,121,7.6,67921,33158000
1567,30000000,Crime,36948322,Carlito's Way,144,7.9,173380,6948322
1568,38000000,Comedy,57319029,Sister Act 2: Back in the Habit,107,5.4,39452,19319029
1569,57000000,Action,58055768,Demolition Man,115,6.6,133674,1055768
1570,42000000,Adventure,20915465,Super Mario Bros.,104,4.0,40601,-21084535
1571,0,Biography,22750363,Rudy,114,7.5,45697,22750363
1572,30000000,Action,53898845,The Three Musketeers,105,6.4,43792,23898845
1573,13000000,Biography,25010410,En el nombre del padre,133,8.1,122973,12010410
1574,40000000,Drama,36300000,Sliver,107,4.9,24457,-3700000
1575,32000000,Adventure,36733909,Alive,120,7.1,42086,4733909
1576,30000000,Drama,32200000,The Age of Innocence,139,7.2,39143,2200000
1577,17000000,Drama,44594000,The Good Son,87,6.4,30596,27594000
1578,15000000,Adventure,68856263,Cool Runnings,98,6.9,75331,53856263
1579,11000000,Comedy,22551000,Much Ado About Nothing,111,7.4,39297,11551000
1580,15000000,Action,23004026,The Program,112,6.4,7889,8004026
1581,14000000,Action,35112679,Dragon: The Bruce Lee Story,120,7.0,23459,21112679
1582,3500000,Crime,27900000,Menace II Society,97,7.5,42874,24400000
1583,0,Comedy,1769305,Naked,132,7.9,26378,1769305
1584,18000000,Action,32589677,Hard Target,97,6.1,37456,14589677
1585,0,Comedy,70172621,Grumpy Old Men,103,6.9,36981,70172621
1586,0,Comedy,51270765,Dennis the Menace,94,5.5,47507,51270765
1587,25000000,Drama,10769960,Gettysburg,271,7.7,22949,-14230040
1588,0,Drama,14543394,The Vanishing,109,6.3,19826,14543394
1589,0,Comedy,44029386,The Beverly Hillbillies,92,4.9,15276,44029386
1590,8000000,Crime,2502551,Red Rock West,98,7.0,16835,-5497449
1591,0,Biography,4104962,This Boy's Life,115,7.3,38466,4104962
1592,20000000,Comedy,11585483,So I Married an Axe Murderer,93,6.4,29457,-8414517
1593,0,Comedy,23202734,Benny & Joon,98,7.2,48597,23202734
1594,0,Drama,1796389,Boxing Helena,107,4.6,10085,1796389
1595,0,Crime,15185672,Needful Things,120,6.2,18215,15185672
1596,15000000,Horror,9579068,The Dark Half,122,5.9,12885,-5420932
1597,3000000,Fantasy,15935068,Jason Goes to Hell: The Final Friday,87,4.3,21333,12935068
1598,40000000,Comedy,48197805,Wayne's World 2,95,6.1,66535,8197805
1599,45000000,Crime,100768056,The Pelican Brief,141,6.6,63850,55768056
1600,15000000,Biography,39100956,What's Love Got to Do with It,118,7.2,14287,24100956
1601,40000000,Action,102314283,In the Line of Fire,128,7.2,78551,62314283
1602,0,Comedy,21274717,Coneheads,88,5.2,44080,21274717
1603,6000000,Drama,13609396,The Crush,89,5.7,12904,7609396
1604,15000000,Biography,20100000,Fire in the Sky,109,6.5,17555,5100000
1605,900000,Comedy,8556940,Leprechaun,92,4.7,18654,7656940
1606,30000000,Crime,31160784,A Perfect World,138,7.5,61676,1160784
1607,0,Comedy,6110979,Short Cuts,188,7.7,37151,6110979
1608,15000000,Drama,22954968,The Remains of the Day,134,7.9,49507,7954968
1609,0,Drama,1324974,Three Colors: Blue,98,8.0,68624,1324974
1610,2000000,Horror,621392,Cronos,94,6.7,21699,-1378608
1611,2600000,Adventure,2850263,Airborne,91,6.2,5414,250263
1612,22000000,Action,10696210,RoboCop 3,104,4.0,37985,-11303790
1613,9000000,Crime,2395231,Kalifornia,117,6.7,44601,-6604769
1614,25000000,Action,38911970,Hot Shots! Part Deux,86,6.6,72228,13911970
1615,0,Action,30038362,Point of No Return,109,6.0,21683,30038362
1616,0,Comedy,36448200,Son in Law,95,5.7,14463,36448200
1617,25000000,Drama,6265311,La casa de los espíritus,140,6.9,18007,-18734689
1618,10000000,Comedy,53579269,Rookie of the Year,103,5.9,19681,43579269
1619,6000000,Animation,5617391,Batman: Mask of the Phantasm,76,7.9,33504,-382609
1620,35000000,Action,63095271,Rising Sun,125,6.2,37093,28095271
1621,0,Drama,24760338,The Man Without a Face,115,6.7,24307,24760338
1622,0,Comedy,10340263,Look Who's Talking Now,96,4.2,23744,10340263
1623,14000000,Drama,27515786,Poetic Justice,109,5.9,9850,13515786
1624,0,Action,18994653,Sniper,98,6.1,20355,18994653
1625,11000000,Comedy,29296,Freaked,86,6.3,4909,-10970704
1626,35000000,Drama,18635620,Geronimo: An American Legend,115,6.5,7190,-16364380
1627,19000000,Comedy,106658,Arizona Dream,142,7.4,36250,-18893342
1628,0,Drama,77848,Stalingrad,134,7.5,25655,77848
1629,20000000,Crime,46044636,Malicia,107,6.4,19410,26044636
1630,30000000,Drama,13275426,El cuerpo del delito,99,4.4,11992,-16724574
1631,0,Drama,5632086,Swing Kids,112,6.8,13893,5632086
1632,14000000,Comedy,1029721,The Thing Called Love,116,6.3,6086,-12970279
1633,0,Drama,6995302,Fearless,122,7.1,18643,6995302
1634,0,Comedy,63270710,Dave,110,6.8,42827,63270710
1635,15000000,Comedy,53354166,Beethoven's 2nd,89,4.8,20989,38354166
1636,35000000,Drama,4858139,Little Buddha,123,6.0,13197,-30141861
1637,12000000,Comedy,6410676,Six Degrees of Separation,112,6.9,17414,-5589324
1638,33000000,Action,5864949,El cielo y la tierra,140,6.8,11419,-27135051
1639,17000000,Action,42660000,Teenage Mutant Ninja Turtles III,96,4.8,26647,25660000
1640,8200000,Action,27979400,Loaded Weapon 1,84,6.1,39412,19779400
1641,0,Comedy,17953778,CB4,89,6.2,7711,17953778
1642,0,Action,4916135,Surf Ninjas,100,5.0,6673,4916135
1643,13000000,Horror,428868,Body Snatchers,87,5.9,14297,-12571132
1644,0,Drama,1499795,M. Butterfly,101,6.8,7251,1499795
1645,0,Animation,9315576,We're Back! A Dinosaur's Story,72,6.1,11383,9315576
1646,0,Drama,9488998,Flesh and Bone,126,6.2,4267,9488998
1647,22000000,Biography,25842000,Shadowlands,131,7.4,14238,3842000
1648,11000000,Drama,32861136,The Joy Luck Club,139,7.6,13064,21861136
1649,2000000,Horror,54207,Return of the Living Dead III,97,5.9,11145,-1945793
1650,21000000,Action,12136938,Judgment Night,110,6.6,12969,-8863062
1651,0,Biography,7266383,Searching for Bobby Fischer,109,7.5,25256,7266383
1652,0,Drama,256264,Dream Lover,103,6.2,3327,256264
1653,1500000,Crime,418953,Killing Zoe,96,6.5,17980,-1081047
1654,30000000,Action,23798623,Striking Distance,102,5.8,35484,-6201377
1655,0,Drama,5216888,Farewell My Concubine,171,8.1,19497,5216888
1656,15000000,Action,22189039,Nowhere to Run,94,5.6,18494,7189039
1657,7500000,Comedy,18899204,Untamed Heart,102,6.8,10810,11399204
1658,30000000,Comedy,10997166,For Love or Money,96,6.1,10037,-19002834
1659,0,Comedy,9532895,Matinee,99,6.8,7511,9532895
1660,0,Comedy,7770731,Sirenas,98,5.8,8692,7770731
1661,13500000,Comedy,11285588,Manhattan Murder Mystery,104,7.4,30925,-2214412
1662,0,Comedy,16581714,Heart and Souls,104,6.9,13859,16581714
1663,0,Drama,322975,The Cement Garden,105,7.2,3847,322975
1664,22000000,Comedy,44942695,Made in America,111,4.9,12718,22942695
1665,0,Drama,50081992,Sommersby,114,6.1,16471,50081992
1666,11500000,Action,3275585,Romeo Is Bleeding,100,6.6,11408,-8224415
1667,6500000,Adventure,24103594,The Adventures of Huck Finn,108,6.2,6666,17603594
1668,15000000,Drama,6419876,The Temp,99,5.1,2554,-8580124
1669,0,Comedy,11081586,Mad Dog and Glory,97,6.2,18138,11081586
1670,0,Crime,3269420,Mi vida loca,92,6.5,1614,3269420
1671,0,Comedy,700000,Los visitantes,107,7.0,26753,700000
1672,0,Drama,1610792,Wide Sargasso Sea,98,5.8,1662,1610792
1673,0,Drama,27484464,My Life,117,6.8,9147,27484464
1674,6000000,Action,3273588,Only the Strong,99,6.7,4542,-2726412
1675,0,Comedy,2093370,Kika,114,6.5,10149,2093370
1676,0,Comedy,3335984,My Boyfriend's Back,85,5.4,3667,3335984
1677,8000000,Comedy,1710000,Even Cowgirls Get the Blues,95,4.3,6381,-6290000
1678,7000000,Adventure,12741891,Weekend at Bernie's II,97,4.6,11036,5741891
1679,9000000,Comedy,14904910,Indian Summer,97,6.5,4338,5904910
1680,0,Comedy,7852653,Fatal Instinct,91,5.7,5807,7852653
1681,13000000,Animation,6574896,Once Upon a Forest,71,6.5,4131,-6425104
1682,0,Comedy,12440858,Life with Mikey,91,5.5,4691,12440858
1683,0,Comedy,12416686,Undercover Blues,90,6.0,6516,12416686
1684,28000000,Animation,669276,The Thief and the Cobbler,72,7.1,2780,-27330724
1685,30000000,Action,8023147,The Meteor Man,100,5.0,5627,-21976853
1686,14000000,Comedy,31888805,Cop & ½,97,3.9,7406,17888805
1687,3000000,Fantasy,3902679,Warlock: The Armageddon,98,5.3,4275,902679
1688,8000000,Drama,1299318,King of the Hill,103,7.6,6291,-6700682
1689,10000000,Action,4247162,Mr. Nanny,84,3.6,7914,-5752838
1690,0,Drama,1497222,A Dangerous Woman,102,5.9,1327,1497222
1691,11000000,Action,14681661,Iron Monkey,90,7.6,13830,3681661
1692,10500000,Drama,810455,"Faraway, So Close!",144,7.3,6278,-9689545
1693,0,Action,6607218,Best of the Best II,101,5.4,4469,6607218
1694,0,Adventure,12890752,A Far Off Place,100,6.6,2952,12890752
1695,18000000,Adventure,1528163,Josh and S.A.M.,96,5.8,1253,-16471837
1696,25000000,Drama,8315975,Mr. Jones,114,5.8,5931,-16684025
1697,10000000,Crime,18369,Deadfall,98,3.7,2376,-9981631
1698,11000000,Crime,16696219,Blink,106,6.2,6770,5696219
1699,1000000,Comedy,6933459,The Wedding Banquet,106,7.7,11573,5933459
1700,10000000,Drama,18272447,Sugar Hill,123,5.9,3376,8272447
1701,6000000,Comedy,12974636,Man's Best Friend,87,5.1,3256,6974636
1702,0,Drama,309117,The Slingshot,102,6.5,1686,309117
1703,10000000,Western,18290000,Posse,111,5.5,3422,8290000
1704,0,Crime,667078,The Advocate,100,6.8,1663,667078
1705,0,Action,20208496,Another Stakeout,108,5.5,11561,20208496
1706,1000000,Horror,1753979,Carnosaur,83,3.5,3208,753979
1707,14000000,Drama,8041049,Aspen Extreme,113,5.8,2414,-5958951
1708,12000000,Horror,5086909,Ghost in the Machine,95,4.4,2839,-6913091
1709,25000000,Comedy,2457574,Son of the Pink Panther,93,3.8,4105,-22542426
1710,0,Drama,322871,House of Cards,100,6.3,2301,322871
1711,0,Action,194720,Crime Story,107,6.8,4566,194720
1712,0,Drama,378854,Germinal,160,7.1,3759,378854
1713,10000000,Drama,72495,Dangerous Game,108,5.7,3022,-9927505
1714,12000000,Biography,1703282,A Home of Our Own,104,7.1,2416,-10296718
1715,0,Comedy,3418141,Father Hood,95,4.8,2440,3418141
1716,0,Comedy,3246063,Splitting Heirs,87,5.5,3515,3246063
1717,19000000,Family,2119994,The Nutcracker,92,5.8,1280,-16880006
1718,11000000,Comedy,1044824,Money for Nothing,100,5.7,3306,-9955176
1719,8000000,Drama,874148,Mother's Boys,96,5.4,2570,-7125852
1720,0,Drama,296081,Ethan Frome,99,6.3,1798,296081
1721,0,Drama,61274,Silent Tongue,102,5.3,922,61274
1722,0,Comedy,9745803,Amos & Andrew,96,5.6,7566,9745803
1723,11900000,Drama,48856,Maadadayo,134,7.4,4081,-11851144
1724,0,Crime,22886222,Guilty as Sin,107,5.6,3881,22886222
1725,0,Crime,6473326,The Real McCoy,105,5.5,7143,6473326
1726,13000000,Comedy,3125424,Mr. Wonderful,98,5.9,2743,-9874576
1727,0,Comedy,1038959,Naked in New York,95,5.7,1393,1038959
1728,0,Drama,5145462,Jack the Bear,99,6.5,3451,5145462
1729,0,Biography,1718328,Blue,79,7.2,1414,1718328
1730,9000000,Action,10058318,Boiling Point,92,4.9,4831,1058318
1731,0,Romance,121548,For the Moment,100,6.3,821,121548
1732,0,Drama,553454,The Innocent,119,5.7,1319,553454
1733,0,Drama,89388,Raining Stones,90,7.5,3399,89388
1734,0,Comedy,2080805,Strawberry and Chocolate,108,7.5,4563,2080805
1735,0,Comedy,9285189,Lost in Yonkers,114,6.7,2180,9285189
1736,999999,Comedy,238230,Fear of a Black Hat,88,7.2,3462,-761769
1737,0,Drama,543091,The Ballad of Little Jo,100,6.8,1211,543091
1738,0,Comedy,11299730,Who's the Man?,100,5.5,1519,11299730
1739,0,Comedy,17952857,Born Yesterday,100,5.1,3296,17952857
1740,8030000,Action,3411885,Gunmen,94,5.2,2861,-4618115
1741,0,Drama,231700,Wrestling Ernest Hemingway,123,7.1,2547,231700
1742,0,Comedy,98967,Totally F***ed Up,78,6.1,2164,98967
1743,0,Comedy,84859,Wilder Napalm,109,5.5,1349,84859
1744,13000000,Drama,2570145,Calendar Girl,90,5.0,1901,-10429855
1745,2500000,Drama,764083,"Bodies, Rest & Motion",95,5.6,2008,-1735917
1746,0,Drama,1910763,The Scent of Green Papaya,104,7.4,6642,1910763
1747,0,Action,3560604,Once Upon a Time in China III,109,6.8,5426,3560604
1748,0,Horror,168180,Witchboard 2,98,5.0,1178,168180
1749,1000000,Drama,2691899,Sankofa,100,7.1,456,1691899
1750,0,Comedy,2786807,Hexed,100,5.5,1313,2786807
1751,0,Biography,472598,Caro diario,100,7.3,5831,472598
1752,0,Drama,21647,Morning Glory,96,6.6,315,21647
1753,0,Comedy,5495507,Three of Hearts,100,5.5,1699,5495507
1754,0,Comedy,120623,Watch It,102,6.4,505,120623
1755,5000000,Action,2970,Philadelphia Experiment II,97,4.5,1526,-4997030
1756,0,Drama,355974,El papalote azul,100,7.7,2170,355974
1757,0,Drama,953755,Love & Human Remains,100,6.7,2248,953755
1758,0,Drama,57115,The Saint of Fort Washington,100,7.2,2027,57115
1759,800000,Drama,1001437,Ruby in Paradise,114,7.1,2137,201437
1760,25000000,Crime,28341469,The Shawshank Redemption,142,9.3,1861666,3341469
1761,8000000,Crime,107928762,Pulp Fiction,154,8.9,1456787,99928762
1762,55000000,Comedy,330252182,Forrest Gump,142,8.8,1402876,275252182
1763,0,Crime,19501238,Léon: The Professional,110,8.6,806235,19501238
1764,45000000,Animation,312900000,The Lion King,88,8.5,723070,267900000
1765,60000000,Drama,105264608,Interview with the Vampire: The Vampire Chronicles,123,7.6,255095,45264608
1766,30000000,Action,121248145,Speed,116,7.2,279357,91248145
1767,0,Comedy,51764950,The Little Rascals,82,6.3,36665,51764950
1768,4400000,Comedy,52700832,Four Weddings and a Funeral,117,7.1,115440,48300832
1769,18000000,Comedy,119938730,The Mask,101,6.9,286352,101938730
1770,16000000,Comedy,127175354,Dumb and Dumber,107,7.3,306934,111175354
1771,34000000,Crime,50282766,Natural Born Killers,118,7.3,185627,16282766
1772,30000000,Drama,66638883,Legends of the Fall,133,7.5,121453,36638883
1773,55000000,Action,71565669,Stargate: la puerta del tiempo,116,7.1,156375,16565669
1774,115000000,Action,146282411,True Lies,141,7.2,202934,31282411
1775,23000000,Action,50693162,The Crow,102,7.6,144969,27693162
1776,12000000,Comedy,72217000,Ace Ventura: Pet Detective,86,6.9,232964,60217000
1777,63000000,Adventure,25052000,Wyatt Earp,191,6.7,38101,-37948000
1778,46000000,Comedy,130512915,The Flintstones,91,4.8,64538,84512915
1779,0,Comedy,45610410,D2: The Mighty Ducks,106,6.0,30231,45610410
1780,11500000,Comedy,20982557,Reality Bites,99,6.6,38652,9482557
1781,35000000,Action,75668868,Star Trek: Generations,118,6.6,64703,40668868
1782,18000000,Biography,5887457,Ed Wood,127,7.9,149166,-12112543
1783,8000000,Fantasy,18090181,New Nightmare,112,6.4,41464,10090181
1784,230000,Comedy,3151130,Clerks,92,7.8,190615,2921130
1785,45000000,Drama,22006296,Mary Shelley's Frankenstein,123,6.4,44892,-22993704
1786,62000000,Action,122187717,Clear and Present Danger,141,6.9,74328,60187717
1787,15000000,Drama,50083616,Little Women,115,7.3,39288,35083616
1788,40000000,Comedy,38087756,Ri¢hie Ri¢h,95,5.3,53644,-1912244
1789,600000,Comedy,141626,Texas Chainsaw Massacre: The Next Generation,95,3.2,16202,-458374
1790,50000000,Adventure,16671505,Baby's Day Out,99,6.0,36625,-33328495
1791,35000000,Action,33423521,Street Fighter,102,3.8,56055,-1576479
1792,20000000,Comedy,19288821,Little Giants,107,6.3,21057,-711179
1793,0,Comedy,5370000,Airheads,92,6.1,40298,5370000
1794,0,Comedy,11220670,"Las aventuras de Priscilla, reina del desierto",104,7.5,39500,11220670
1795,5000000,Biography,3049135,Criaturas celestiales,99,7.4,52852,-1950865
1796,8000000,Fantasy,8946600,In the Mouth of Madness,95,7.2,47554,946600
1797,31000000,Drama,33683817,Nell,112,6.5,23973,2683817
1798,45000000,Crime,92115211,The Client,119,6.7,49609,47115211
1799,75000000,Action,101631272,Maverick,127,7.0,88132,26631272
1800,22000000,Comedy,144833357,The Santa Clause,97,6.4,71963,122833357
1801,0,Drama,22355000,Blue Chips,108,6.1,10150,22355000
1802,0,Comedy,25479558,My Father the Hero,90,5.4,9254,25479558
1803,0,Crime,600200,Chungking Express,102,8.1,45500,600200
1804,45000000,Action,57362581,The Specialist,110,5.5,53868,12362581
1805,0,Comedy,30577969,Blank Check,93,5.2,15449,30577969
1806,40000000,Comedy,24332324,Renaissance Man,128,6.1,14657,-15667676
1807,27000000,Adventure,44342956,El Libro de la Selva,111,6.0,14034,17342956
1808,3000000,Comedy,15185594,La boda de Muriel,106,7.2,29720,12185594
1809,24000000,Comedy,50236831,Angels in the Outfield,102,6.1,23966,26236831
1810,55000000,Action,42610000,Beverly Hills Cop III,104,5.5,64891,-12390000
1811,31000000,Biography,24822619,Quiz Show,133,7.5,57114,-6177381
1812,55000000,Drama,83015089,Disclosure,128,6.0,39139,28015089
1813,0,Crime,2201126,Somos guerreros,102,7.9,27093,2201126
1814,0,Comedy,20160000,"Corrina, Corrina",115,6.5,10650,20160000
1815,70000000,Drama,65012000,Wolf,125,6.2,46095,-4988000
1816,30000000,Comedy,51132598,Naked Gun 33 1/3: The Final Insult,83,6.5,82374,21132598
1817,0,Romance,15240435,Bad Girls,99,5.1,10190,15240435
1818,27000000,Animation,13670688,The Pagemaster,80,6.0,17391,-13329312
1819,30000000,Comedy,2869369,The Hudsucker Proxy,111,7.3,68649,-27130631
1820,40000000,Mystery,19721814,Color of Night,121,5.1,19835,-20278186
1821,45000000,Action,46815748,The River Wild,111,6.3,35146,1815748
1822,8000000,Comedy,4350774,PCU,79,6.6,10934,-3649226
1823,0,Drama,4043686,Three Colors: Red,99,8.1,69096,4043686
1824,25000000,Comedy,22150451,Don Juan DeMarco,97,6.7,43444,-2849549
1825,0,Adventure,10471613,Camp Nowhere,96,5.9,7684,10471613
1826,10000000,Action,11546543,The Legend of Drunken Master,102,7.6,37144,1546543
1827,60000000,Comedy,36763355,Junior,109,4.6,56919,-23236645
1828,27000000,Action,44853581,Timecop: Policía del futuro,99,5.8,47553,17853581
1829,0,Comedy,20042048,Only You,115,6.5,16746,20042048
1830,0,Comedy,17359799,My Girl 2,99,5.2,15940,17359799
1831,20000000,Animation,9771658,The Swan Princess,100,6.4,18972,-10228342
1832,0,Comedy,30626182,Major League II,105,5.5,21665,30626182
1833,3500000,Crime,16036534,Above the Rim,96,6.6,11508,12536534
1834,0,Action,16096000,The Getaway,115,5.7,14913,16096000
1835,0,Comedy,37800323,It Could Happen to You,101,6.3,29594,37800323
1836,0,Biography,9914409,Immortal Beloved,121,7.5,20038,9914409
1837,18000000,Comedy,11300653,Ready to Wear,133,5.0,12985,-6699347
1838,2500000,Crime,6138485,The Last Seduction,110,7.1,17307,3638485
1839,0,Drama,50021959,When a Man Loves a Woman,126,6.5,17718,50021959
1840,0,Drama,4183379,Exótica,103,7.2,15366,4183379
1841,50000000,Action,38590500,On Deadly Ground,101,4.4,19210,-11409500
1842,25000000,Comedy,6841570,Exit to Eden,113,4.1,5798,-18158430
1843,0,Comedy,14815000,Threesome,89,6.2,11407,14815000
1844,7400000,Action,7690013,Surviving the Game,96,6.1,8846,290013
1845,2500000,Crime,2881508,Shallow Grave,89,7.3,49100,381508
1846,14000000,Comedy,13640000,Crooklyn,115,6.9,6583,-360000
1847,16000000,Drama,3359465,Blue Sky,101,6.4,5683,-12640535
1848,12000000,Action,8914777,The Next Karate Kid,107,4.3,20024,-3085223
1849,50000000,Action,30155037,Blown Away,121,6.2,24421,-19844963
1850,0,Horror,8638072,The Puppet Masters,109,5.9,7281,8638072
1851,28000000,Animation,11373501,Pulgarcita,100,6.4,12483,-16626499
1852,0,Family,17193886,Miracle on 34th Street,114,6.4,24126,17193886
1853,25000000,Action,32055248,The Shadow,108,6.0,19958,7055248
1854,0,Comedy,1596700,Chasers,102,5.0,4804,1596700
1855,0,Biography,2017346,Queen Margot,159,7.5,14377,2017346
1856,20000000,Comedy,13383737,Bullets Over Broadway,98,7.5,31237,-6616263
1857,0,Comedy,28864707,In the Army Now,91,4.8,10622,28864707
1858,13000000,Comedy,7881335,Serial Mom,95,6.7,22529,-5118665
1859,0,Comedy,1464625,Three Colors: White,91,7.7,48877,1464625
1860,0,Adventure,4630377,Black Beauty,88,6.6,7810,4630377
1861,0,Comedy,20043254,With Honors,103,6.7,11565,20043254
1862,40000000,Adventure,7138449,North,87,4.4,11852,-32861551
1863,20000000,Action,15340000,No Escape,118,6.1,16576,-4660000
1864,0,Drama,16551365,The War,126,6.7,10752,16551365
1865,3000000,Biography,21848932,Il Postino,108,7.7,27999,18848932
1866,20000000,Comedy,39487686,Nobody's Fool,110,7.4,15759,19487686
1867,0,Comedy,4264509,Brainscan,96,6.1,8826,4264509
1868,0,Biography,15238994,The Madness of King George,104,7.2,12850,15238994
1869,0,Comedy,60822,It's Pat: The Movie,77,2.6,8844,60822
1870,3500000,Crime,8094616,Fresh,114,7.6,10327,4594616
1871,0,Comedy,18137661,Milk Money,110,5.5,9880,18137661
1872,0,Adventure,16819465,Andre,100,5.7,5543,16819465
1873,25000000,Comedy,6507514,The Road to Wellville,118,5.8,10226,-18492486
1874,11000000,Comedy,11439193,The Ref,96,6.9,20548,439193
1875,7000000,Biography,19604000,8 Seconds,105,6.5,4037,12604000
1876,0,Comedy,7294403,Eat Drink Man Woman,124,7.8,14947,7294403
1877,0,Action,8009329,The Chase,100,5.8,15239,8009329
1878,6200000,Comedy,126247,Police Academy: Mission to Moscow,83,3.3,26638,-6073753
1879,10000000,Action,29392418,A Low Down Dirty Shame,100,5.9,4331,19392418
1880,7850000,Action,2341309,Double Dragon,96,3.7,9200,-5508691
1881,200000,Comedy,1359736,Spanking the Monkey,100,6.3,5363,1159736
1882,12000000,Drama,2104000,Death and the Maiden,103,7.3,18786,-9896000
1883,0,Drama,19710,De amor y de sombras,100,5.1,1592,19710
1884,40000000,Comedy,43622150,City Slickers II: The Legend of Curly's Gold,116,5.5,15982,3622150
1885,25000000,Comedy,26372663,I.Q.,100,6.2,20930,1372663
1886,19000000,Comedy,7411659,Clifford,90,5.3,5807,-11588341
1887,0,Animation,71368,A Troll in Central Park,76,5.4,4914,71368
1888,35000000,Action,20277185,The Cowboy Way,102,5.8,6634,-14722815
1889,0,Comedy,13145977,Greedy,113,6.2,11022,13145977
1890,0,Comedy,12211068,Little Big League,119,6.1,8249,12211068
1891,20000000,Family,11784000,3 Ninjas Kick Back,93,4.4,7189,-8216000
1892,15000000,Comedy,6798240,Mixed Nuts,97,5.4,8563,-8201760
1893,700000,Comedy,376928,Swimming with Sharks,93,7.1,20003,-323072
1894,45000000,Action,28720380,Drop Zone,101,5.6,16774,-16279620
1895,5000000,Action,1702394,Death Wish V: The Face of Death,95,4.7,5329,-3297606
1896,7000000,Crime,20851521,Jason's Lyric,120,6.6,2838,13851521
1897,45000000,Drama,20928892,Intersection,98,5.2,6432,-24071108
1898,0,Adventure,16344520,Mi adorable delincuente,96,5.3,5382,16344520
1899,0,Adventure,21006361,Iron Will,108,6.5,6113,21006361
1900,4000000,Comedy,253969,Cemetery Man,105,7.3,17110,-3746031
1901,0,Comedy,16821273,Lightning Jack,98,5.4,5541,16821273
1902,50000000,Action,16478900,Terminal Velocity,102,5.4,11352,-33521100
1903,26000000,Action,13829734,Highlander: The Final Dimension,99,4.3,17307,-12170266
1904,1900000,Drama,763847,Before the Rain,113,8.1,11967,-1136153
1905,0,Drama,2332728,To Live,133,8.3,12705,2332728
1906,6000000,Comedy,38824341,The Paper,112,6.6,11123,32824341
1907,0,Adventure,3662459,Cabin Boy,80,5.1,7171,3662459
1908,0,Comedy,161410,Sleep with Me,86,5.7,2233,161410
1909,2800000,Drama,2616503,Burnt by the Sun,135,8.0,11998,-183497
1910,0,Drama,217881,Sister My Sister,100,6.9,2712,217881
1911,60000000,Comedy,18250211,Love Affair,108,5.9,3922,-41749789
1912,0,Comedy,1777020,I Like It Like That,104,6.8,1290,1777020
1913,30000000,Comedy,18438164,Getting Even with Dad,109,4.6,6383,-11561836
1914,0,Adventure,4358940,Wagons East,107,4.7,4191,4358940
1915,45000000,Action,30806194,I Love Trouble,123,5.2,10145,-14193806
1916,0,Comedy,19281235,House Party 3,100,4.1,2684,19281235
1917,2000000,Comedy,2260622,Leprechaun 2,85,4.4,6778,260622
1918,0,Comedy,7892208,Blankman,92,4.8,7048,7892208
1919,0,Action,1422749,Death Machine,99,5.7,3032,1422749
1920,0,Drama,4176932,Priest,105,7.1,8634,4176932
1921,0,Comedy,319123,Trading Mom,100,5.5,1451,319123
1922,0,Biography,2392599,Backbeat,100,6.7,5047,2392599
1923,0,Action,173526,Ashes of Time,100,7.2,10951,173526
1924,0,Comedy,2667163,The Scout,101,5.3,5255,2667163
1925,3000000,Drama,6101600,The Secret of Roan Inish,103,7.5,6305,3101600
1926,0,Comedy,11384038,Cops and Robbersons,93,5.0,5507,11384038
1927,7000000,Biography,2144667,Mrs. Parker and the Vicious Circle,125,6.4,3789,-4855333
1928,0,Adventure,12712,War of the Buttons,94,7.5,3452,12712
1929,20000000,Comedy,27053498,Guarding Tess,96,6.2,13526,7053498
1930,15000000,Crime,3038499,China Moon,99,6.2,4508,-11961501
1931,30000000,Comedy,1519366,Being Human,122,5.4,3439,-28480634
1932,0,Crime,202458,A Pure Formality,108,7.8,7749,202458
1933,17080000,Comedy,21011500,The Air Up There,107,5.5,7663,3931500
1934,20000000,Action,305070,Rapa Nui,107,6.4,4075,-19694930
1935,0,Adventure,5777916,Trapped in Paradise,111,5.9,10599,5777916
1936,2300000,Crime,1095885,Little Odessa,98,6.8,6076,-1204115
1937,13000000,Comedy,3134081,The Favor,97,5.3,2201,-9865919
1938,0,Comedy,63649,S.F.W.,96,5.9,4242,63649
1939,0,Comedy,20664501,Speechless,99,5.7,4298,20664501
1940,0,Biography,1007583,Cobb,128,6.5,6227,1007583
1941,15000000,Comedy,70936,It Runs in the Family,85,5.7,1234,-14929064
1942,0,Family,9979683,Lassie,94,5.9,4198,9979683
1943,0,Biography,2122948,Farinelli,111,6.9,5412,2122948
1944,0,Drama,3428774,A Simple Twist of Fate,106,6.3,4420,3428774
1945,2300000,Comedy,856422,Amateur,105,7.0,4804,-1443578
1946,30000000,Drama,3180674,Silent Fall,100,5.9,3114,-26819326
1947,0,Crime,3313633,The Glass Shield,109,6.6,2960,3313633
1948,3200000,Comedy,7266973,Barcelona,101,7.0,4843,4066973
1949,10500000,Comedy,123509,There Goes My Baby,99,6.4,902,-10376491
1950,0,Adventure,8878839,White Fang 2: Myth of the White Wolf,100,5.4,1764,8878839
1951,0,Drama,124693,Oleanna,89,6.7,2499,124693
1952,30000000,Crime,3692874,Jimmy Hollywood,112,5.3,2702,-26307126
1953,0,Comedy,3021629,Princess Caraboo,97,6.0,2187,3021629
1954,44000000,Comedy,10209111,I'll Do Anything,115,5.6,2180,-33790889
1955,15000000,Comedy,1299060,Radioland Murders,108,6.2,2920,-13700940
1956,200000,Horror,986314,Mosquito,92,4.6,1715,786314
1957,0,Comedy,766464,The Sum of Us,100,7.4,4544,766464
1958,0,Drama,464423,The Browning Version,97,7.3,2624,464423
1959,0,Comedy,9398308,Angie,107,5.4,1838,9398308
1960,0,Comedy,1746050,Vanya on 42nd Street,119,7.5,3622,1746050
1961,0,Drama,759393,Double Happiness,87,7.2,961,759393
1962,15000,Drama,2408311,Go Fish,83,5.6,1742,2393311
1963,10700000,Comedy,1238080,"Car 54, Where Are You?",89,2.4,4018,-9461920
1964,0,Drama,8534,River of Grass,76,6.5,626,8534
1965,0,Biography,538534,Tom & Viv,100,6.5,1357,538534
1966,1000000,Drama,446934,Nadja,93,6.0,2586,-553066
1967,0,Drama,917915,Wild Reeds,110,7.6,4397,917915
1968,0,Drama,152457,Ladybird Ladybird,101,7.5,2568,152457
1969,19200000,Adventure,3337685,Squanto: A Warrior's Tale,102,6.1,939,-15862315
1970,0,Comedy,304852,Dance Me Outside,84,7.3,957,304852
1971,0,Comedy,642000,The Monster,112,7.5,8177,642000
1972,0,Drama,40300,Through the Olive Trees,103,7.8,4232,40300
1973,0,Adventure,1000000,"Little Indian, Big City",100,5.6,3362,1000000
1974,18000000,Comedy,7503192,Clean Slate,107,5.7,3264,-10496808
1975,0,Comedy,713234,Holy Matrimony,93,5.1,1113,713234
1976,0,Comedy,366506,Maybe... Maybe Not,93,6.6,5089,366506
1977,20000000,Comedy,2308390,A Good Man in Africa,94,5.0,2032,-17691610
1978,0,Drama,111015,I Can't Sleep,110,7.0,894,111015
1979,0,Action,311922,La fille de d'Artagnan,125,5.9,2764,311922
1980,33000000,Crime,100125643,Se7en,127,8.6,1134655,67125643
1981,50000000,Action,100475249,Jumanji,104,6.9,232339,50475249
1982,72000000,Biography,75600000,Braveheart,178,8.4,807256,3600000
1983,6000000,Crime,23341568,The Usual Suspects,106,8.6,814470,17341568
1984,60000000,Action,67436818,Heat,170,8.2,470080,7436818
1985,12000000,Comedy,56631572,Clueless,97,6.8,136975,44631572
1986,55000000,Animation,141600000,Pocahontas,81,6.7,133708,86600000
1987,29000001,Mystery,57141459,Twelve Monkeys,129,8.0,500403,28141458
1988,30000000,Animation,191796233,Toy Story,81,8.3,694113,161796233
1989,100000000,Action,184031112,Batman Forever,121,5.4,203965,84031112
1990,60000000,Action,106600000,GoldenEye,130,7.2,209588,46600000
1991,52000000,Crime,42438300,Casino,178,8.2,367532,-9561700
1992,1500000,Drama,7417210,Kids,91,7.0,63097,5917210
1993,45000000,Drama,20302961,Showgirls,128,4.7,53325,-24697039
1994,50000000,Comedy,100328194,Casper,100,6.0,94596,50328194
1995,0,Animation,515905,Ghost in the Shell,83,8.0,101716,515905
1996,3500000,Comedy,27467564,Friday,91,7.3,82224,23967564
1997,2500000,Drama,5535405,Before Sunrise,101,8.1,207167,3035405
1998,18000000,Action,70454098,Mortal Kombat,101,5.8,87007,52454098
1999,52000000,Adventure,173837933,Apollo 13,140,7.6,224635,121837933
2000,20000000,Comedy,7564000,Hackers,107,6.2,57821,-12436000
2001,19000000,Action,65807024,Bad Boys,119,6.8,186965,46807024
2002,90000000,Action,100012499,Die Hard with a Vengeance,128,7.6,317792,10012499
2003,10000000,Comedy,25588750,Billy Madison,89,6.4,112423,15588750
2004,175000000,Action,88246220,Waterworld,135,6.1,153742,-86753780
2005,50000000,Action,81022101,Congo,109,5.1,36705,31022101
2006,16000000,Drama,43182776,Sense and Sensibility,136,7.7,84237,27182776
2007,30250000,Comedy,72077000,Get Shorty,105,6.9,66364,41827000
2008,62000000,Comedy,65000000,The American President,114,6.8,45293,3000000
2009,25000000,Action,4064333,Tank Girl,104,5.3,26302,-20935667
2010,9500000,Drama,30862146,Powder,111,6.6,25582,21362146
2011,35000000,Action,60074103,Species,108,5.8,64667,25074103
2012,18000000,Fantasy,1513028,The City of Lost Children,112,7.7,58437,-16486972
2013,3600000,Drama,31968347,Adiós a Las Vegas,111,7.6,99239,28368347
2014,0,Biography,2424439,The Basketball Diaries,102,7.3,86655,2424439
2015,7000000,Action,25625110,Desperado,104,7.2,147918,18625110
2016,0,Comedy,17689177,Heavy Weights,100,6.7,21136,17689177
2017,0,Comedy,303841,Empire Records,90,6.7,40911,303841
2018,30000000,Comedy,66600000,"Babe, el puerquito valiente",91,6.8,100541,36600000
2019,42000000,Action,7919000,Strange Days,145,7.2,57697,-34081000
2020,30000000,Adventure,108385533,Ace Ventura: When Nature Calls,90,6.3,172305,78385533
2021,4000000,Comedy,4301331,Four Rooms,98,6.7,83723,301331
2022,0,Crime,309811,La Haine,98,8.1,115435,309811
2023,17000000,Comedy,81057016,While You Were Sleeping,103,6.7,76882,64057016
2024,32000000,Action,18636537,Rápida y mortal,107,6.4,73223,-13363463
2025,0,Adventure,29412050,Major Payne,100,6.2,24344,29412050
2026,70000000,Action,34693481,Judge Dredd,96,5.5,95091,-35306519
2027,0,Animation,35348597,A Goofy Movie,78,6.8,36877,35348597
2028,22000000,Horror,9417567,Village of the Damned,99,5.6,23569,-12582433
2029,0,Adventure,32700000,Tommy Boy,97,7.1,66163,32700000
2030,17000000,Drama,10019307,A Little Princess,97,7.7,26945,-6980693
2031,12000000,Comedy,46576136,The Brady Bunch Movie,90,5.9,18224,34576136
2032,11000000,Crime,39387284,Dead Man Walking,122,7.6,77349,28387284
2033,25000000,Comedy,69870000,Grumpier Old Men,101,6.6,20718,44870000
2034,0,Comedy,36474193,"To Wong Foo Thanks for Everything, Julie Newmar",109,6.4,22962,36474193
2035,0,Comedy,27400000,Now and Then,100,6.8,22719,27400000
2036,0,Comedy,19474589,It Takes Two,101,5.8,16200,19474589
2037,20000000,Drama,32051917,Copycat,123,6.6,45066,12051917
2038,0,Crime,24361867,Dolores Claiborne,132,7.4,30927,24361867
2039,15000000,Action,37804616,Mighty Morphin Power Rangers: The Movie,95,5.1,21647,22804616
2040,50000000,Action,67823573,Outbreak,127,6.6,95549,17823573
2041,9000000,Drama,1037847,Dead Man,121,7.7,77407,-7962153
2042,53000000,Action,91400000,Crimson Tide,116,7.3,86579,38400000
2043,24000000,Drama,71516617,The Bridges of Madison County,135,7.6,58975,47516617
2044,23000000,Biography,84919401,Dangerous Minds,99,6.4,40880,61919401
2045,20000000,Comedy,21284514,To Die For,106,6.8,36974,1284514
2046,0,Comedy,704543,Kicking and Screaming,96,7.0,7594,704543
2047,6000000,Comedy,2122561,Mallrats,94,7.2,103484,-3877439
2048,5000000,Horror,15116634,Halloween: The Curse of Michael Myers,87,5.0,22890,10116634
2049,60000000,Action,50024083,Under Siege 2: Dark Territory,100,5.4,38220,-9975917
2050,25000000,Action,19076000,Johnny Mnemonic,100,5.6,58885,-5924000
2051,0,Crime,38290723,Higher Learning,127,6.5,15576,38290723
2052,20000000,Drama,50012507,A Walk in the Clouds,102,6.7,26520,30012507
2053,15000000,Comedy,6700000,Mighty Aphrodite,95,7.1,33697,-8300000
2054,50000000,Action,30306268,Assassins,132,6.3,67317,-19693732
2055,58000000,Comedy,53672080,Sabrina,127,6.3,31451,-4327920
2056,28000000,Adventure,31600000,Rob Roy,139,6.9,36234,3600000
2057,55000000,Action,37600435,First Knight,134,5.9,59052,-17399565
2058,30000000,Comedy,10693649,Drácula: Muerto pero feliz,88,5.8,32629,-19306351
2059,98000000,Action,10017322,Cutthroat Island,124,5.6,22527,-87982678
2060,13000000,Action,21088568,Tales from the Crypt: Demon Knight,92,6.7,17728,8088568
2061,22000000,Action,50727965,The Net,114,5.9,51864,28727965
2062,10000000,Action,24200000,Dead Presidents,119,6.8,16395,14200000
2063,0,Comedy,38896854,French Kiss,111,6.6,40933,38896854
2064,45000000,Drama,35617599,The Indian in the Cupboard,96,5.9,22044,-9382401
2065,23000000,Drama,82569971,Mr. Holland's Opus,143,7.3,31602,59569971
2066,50000000,Drama,10400000,The Scarlet Letter,135,5.2,12706,-39600000
2067,20000000,Comedy,19751736,Vampire in Brooklyn,100,4.5,18359,-248264
2068,0,Animation,11268750,Balto,100,7.1,32984,11268750
2069,15000000,Adventure,13406717,A Kid in King Arthur's Court,89,4.8,4897,-1593283
2070,8000000,Action,16115878,The Prophecy,98,6.6,25657,8115878
2071,30000000,Comedy,76594000,Father of the Bride Part II,106,5.9,28658,46594000
2072,0,Drama,1194152,When Night Is Falling,94,6.7,5706,1194152
2073,800000,Comedy,4771000,Welcome to the Dollhouse,88,7.4,28073,3971000
2074,30000000,Action,2167808,Wild Bill,98,5.9,5307,-27832192
2075,20000000,Sci-Fi,5781885,Asesinos cibernéticos,108,6.4,21565,-14218115
2076,6500000,Comedy,9685976,The Baby-Sitters Club,94,5.7,4594,3185976
2077,8000000,Biography,339889,Total Eclipse,111,6.6,11309,-7660111
2078,30000000,Action,24048000,Virtuosity,106,5.6,24720,-5952000
2079,50000000,Biography,13560960,Nixon,192,7.1,25426,-36439040
2080,50000000,Crime,9795017,Jade,95,5.2,9815,-40204983
2081,12000000,Comedy,17725500,The Big Green,100,5.5,7500,5725500
2082,12000000,Horror,13293081,Lord of Illusions,109,6.0,11887,1293081
2083,7500000,Action,32392047,Rumble in the Bronx,104,6.7,32513,24892047
2084,1000000,Drama,512245,Safe,119,7.2,9448,-487755
2085,0,Action,36853222,Just Cause,102,6.4,20952,36853222
2086,10000000,Comedy,23574130,How to Make an American Quilt,117,6.2,9152,13574130
2087,0,Comedy,442965,The Last Supper,92,6.8,12713,442965
2088,11000000,Drama,2112951,Othello,123,6.9,7965,-8887049
2089,0,Comedy,50892160,Something to Talk About,106,5.7,11105,50892160
2090,16000000,Comedy,67052156,Waiting to Exhale,124,5.7,7977,51052156
2091,0,Horror,1781383,El triturador,106,4.0,7031,1781383
2092,0,Drama,17382000,Murder in the First,122,7.3,23058,17382000
2093,0,Adventure,30077111,Free Willy 2: The Adventure Home,95,4.9,13906,30077111
2094,35000000,Action,20350171,Sudden Death,111,5.7,27472,-14649829
2095,0,Comedy,69700000,Nine Months,103,5.4,31410,69700000
2096,25000000,Crime,13040603,Clockers,128,6.9,17650,-11959397
2097,0,Action,15324,The Day of the Beast,103,7.5,13867,15324
2098,0,Drama,23397365,Círculo de amigos,103,6.6,7310,23397365
2099,0,Action,24700000,Operation Dumbo Drop,107,5.0,7352,24700000
2100,0,Comedy,40070995,Man of the House,96,5.0,7041,40070995
2101,7000000,Crime,529766,Things to Do in Denver When You're Dead,115,6.8,23358,-6470234
2102,11000000,Comedy,178104,Canadian Bacon,91,5.9,14286,-10821896
2103,5500000,Drama,11079373,My Family,128,7.3,3222,5579373
2104,0,Adventure,23735802,Tom and Huck,97,5.6,8150,23735802
2105,0,Action,259319,The Doom Generation,83,6.0,12096,259319
2106,500000,Comedy,1148752,Living in Oblivion,90,7.6,13615,648752
2107,7000000,Comedy,8349430,Smoke,112,7.4,29466,1349430
2108,27000000,Crime,16030096,Devil in a Blue Dress,102,6.7,14406,-10969904
2109,9000000,Drama,832910,The Crossing Guard,111,6.3,11262,-8167090
2110,0,Adventure,6029091,Gold Diggers: The Secret of Bear Mountain,94,6.0,3561,6029091
2111,68000000,Action,35324232,Money Train,110,5.6,34091,-32675768
2112,0,Drama,62949,Delta of Venus,99,4.5,1596,62949
2113,33000000,Action,8169363,Nick of Time,90,6.3,34436,-24830637
2114,20000000,Comedy,17518220,Home for the Holidays,103,6.6,9567,-2481780
2115,40000000,Action,14942422,Kiss of Death,101,5.9,14977,-25057578
2116,0,Drama,2600000,Richard III,110,7.5,12218,2600000
2117,6000000,Crime,11797927,Tales from the Hood,98,6.2,5082,5797927
2118,17000000,Drama,7603766,Losing Isaiah,111,6.4,4713,-9396234
2119,21000000,Comedy,23450000,Boys on the Side,115,6.4,10182,2450000
2120,32000000,Adventure,8247627,Tall Tale,98,5.9,2814,-23752373
2121,15000000,Drama,6014340,The Walking Dead,88,4.8,652,-8985660
2122,0,Adventure,7919823,Bushwhacked,90,5.5,4842,7919823
2123,25000,Comedy,10246600,The Brothers McMullen,98,6.6,6598,10221600
2124,0,Comedy,12100000,Bye Bye Love,106,6.1,4239,12100000
2125,50000000,Action,11534477,Fair Game,91,4.1,10655,-38465523
2126,0,Adventure,7400000,Last of the Dogmen,118,6.9,4209,7400000
2127,0,Drama,5304000,Angels and Insects,116,7.0,4083,5304000
2128,0,Drama,2568429,The Cure,97,7.7,8061,2568429
2129,0,Comedy,4821759,Angus,90,6.7,5736,4821759
2130,0,Comedy,407618,3 Ninjas Knuckle Up,85,4.1,4527,407618
2131,0,Drama,986128,Heavy,105,7.0,3835,986128
2132,0,Adventure,4686937,Senior Trip,91,5.6,4845,4686937
2133,250000,Comedy,1977544,The Incredibly True Adventure of Two Girls in Love,94,6.5,3759,1727544
2134,7000000,Drama,3760515,White Man's Burden,89,5.2,4197,-3239485
2135,0,Comedy,33194500,Forget Paris,101,6.4,9897,33194500
2136,15000000,Drama,3987649,Fluke,96,6.7,5577,-11012351
2137,0,Horror,13940383,Candyman: Farewell to the Flesh,93,5.2,8119,13940383
2138,19000000,Biography,4100000,Restoration,117,6.7,7894,-14900000
2139,0,Comedy,5221281,Miami Rhapsody,95,5.4,2821,5221281
2140,0,Comedy,10904930,The Englishman Who Went Up a Hill But Came Down a Mountain,99,6.6,14381,10904930
2141,0,Horror,302393,The Addiction,82,6.4,7077,302393
2142,0,Crime,76882,La Cérémonie,112,7.6,7614,76882
2143,2000000,Comedy,1275999,Blue in the Face,83,6.7,8035,-724001
2144,10000000,Action,6607652,The Hunted,100,5.9,3978,-3392348
2145,10500000,Comedy,26325256,Houseguest,113,5.9,4716,15825256
2146,0,Drama,30890,Beyond the Clouds,112,6.5,4750,30890
2147,15000000,Fantasy,12201255,Hideaway,106,5.3,5398,-2798745
2148,28000000,Animation,3983912,La piedra y el pingüino,74,5.6,3607,-24016088
2149,0,Comedy,17014653,Jury Duty,88,4.1,6575,17014653
2150,6400000,Crime,6849998,Never Talk to Strangers,86,5.1,5483,449998
2151,0,Drama,1162000,The Flower of My Secret,103,7.1,8430,1162000
2152,0,Comedy,218626,Jack & Sarah,110,6.6,4448,218626
2153,0,Drama,230187,Land and Freedom,109,7.6,8477,230187
2154,8000000,Comedy,2763020,Dr. Jekyll and Ms. Hyde,100,4.4,2379,-5236980
2155,0,Drama,15453274,Mad Love,93,5.3,5568,15453274
2156,14000000,Biography,2474000,Jefferson in Paris,139,5.7,2535,-11526000
2157,0,Drama,42202,Ulysses' Gaze,176,7.6,4957,42202
2158,0,Comedy,4823217,Antonia's Line,102,7.5,7174,4823217
2159,0,Crime,3700000,Bad Company,108,5.4,2411,3700000
2160,5000000,Crime,3565508,New Jersey Drive,98,6.7,2341,-1434492
2161,0,Comedy,532268,Funny Bones,128,7.0,3191,532268
2162,4000000,Comedy,258195,An Awfully Big Adventure,112,6.0,2273,-3741805
2163,0,Comedy,2488858,Moonlight and Valentino,105,5.8,3086,2488858
2164,150000,Comedy,472370,Party Girl,94,6.6,3784,322370
2165,23000000,Action,5750110,Beyond Rangoon,100,6.6,4306,-17249890
2166,0,Comedy,3487767,Jeffrey,92,6.7,5075,3487767
2167,0,Family,7506759,The Amazing Panda Adventure,100,5.8,3344,7506759
2168,0,Drama,6834525,Panther,100,6.4,1943,6834525
2169,3000000,Comedy,294991,Rumpelstiltskin,87,4.4,1935,-2705009
2170,6500000,Crime,536023,The Underneath,99,6.2,2718,-5963977
2171,0,Adventure,11642946,Far from Home: The Adventures of Yellow Dog,81,6.4,2182,11642946
2172,0,Biography,3242342,Carrington,121,6.9,4621,3242342
2173,0,Drama,1110104,Georgia,115,6.5,2530,1110104
2174,0,Adventure,3674841,Born to Be Wild,100,5.1,1191,3674841
2175,0,Drama,7025496,Three Wishes,115,6.2,2311,7025496
2176,0,Comedy,7557877,The Jerky Boys,100,4.6,2209,7557877
2177,11000000,Comedy,2832826,The Perez Family,100,6.1,1847,-8167174
2178,6000000,Action,5093707,Top Dog,86,4.1,2629,-906293
2179,0,Adventure,47687,Napoleon,81,6.1,1353,47687
2180,0,Drama,26282,Two Bits,85,6.3,2903,26282
2181,2000000,Horror,1204430,Mute Witness,95,6.8,4634,-795570
2182,0,Drama,116797,The Star Maker,113,7.4,4129,116797
2183,0,Comedy,911310,Stuart Saves His Family,100,5.3,2375,911310
2184,8000000,Drama,493007,The Grass Harp,107,7.2,3093,-7506993
2185,0,Comedy,3992809,Gordy,100,3.9,1701,3992809
2186,0,Biography,65682,Killer: A Journal of Murder,91,6.4,1888,65682
2187,0,Drama,76875,Flirt,85,6.3,1677,76875
2188,0,Adventure,1877179,The Horseman on the Roof,135,7.1,5076,1877179
2189,0,Crime,1176982,Destiny Turns on the Radio,102,4.5,1959,1176982
2190,22000000,Comedy,12100000,Roommates,108,6.4,1509,-9900000
2191,0,Comedy,346839,A Midwinter's Tale,99,7.3,2095,346839
2192,0,Adventure,2643346,Magic in the Water,98,5.8,1681,2643346
2193,0,Adventure,15054389,Wings of Courage,50,6.5,537,15054389
2194,0,Comedy,7929241,Unstrung Heroes,93,6.7,2788,7929241
2195,0,Comedy,2196534,A Month by the Lake,92,6.4,1897,2196534
2196,0,Drama,136153,A Single Girl,90,7.2,1272,136153
2197,150000,Drama,474047,The White Balloon,85,7.8,5258,324047
2198,10000000,Musical,44757,The Fantasticks,86,5.8,1008,-9955243
2199,0,Drama,961147,Separate Lives,102,5.0,596,961147
2200,92000000,Action,241721524,Twister,113,6.3,152463,149721524
2201,3500000,Drama,16501785,Trainspotting,94,8.2,530849,13001785
2202,7000000,Crime,24611975,Fargo,98,8.1,500735,17611975
2203,14000000,Horror,103046663,Scream,111,7.2,238628,89046663
2204,19000000,Action,25753840,From Dusk Till Dawn,108,7.3,236890,6753840
2205,75000000,Action,306169255,Independence Day,145,7.0,461225,231169255
2206,14500000,Drama,46351345,Romeo + Juliet,120,6.8,180239,31851345
2207,36000000,Comedy,33084249,Matilda,98,6.8,98249,-2915751
2208,12000000,Comedy,38624000,Happy Gilmore,92,7.0,166846,26624000
2209,3000000,Crime,4109095,Kama Sutra: A Tale of Love,117,6.0,8807,1109095
2210,44000000,Crime,49100000,Sleepers,147,7.6,163662,5100000
2211,27000000,Drama,78651430,The English Patient,162,7.4,152610,51651430
2212,50000000,Comedy,153952592,Jerry Maguire,139,7.3,204244,103952592
2213,15000000,Drama,24881000,The Craft,101,6.3,62195,9881000
2214,80000000,Action,180981856,Mission: Impossible,110,7.1,323291,100981856
2215,30000000,Crime,56116183,Primal Fear,129,7.7,144847,26116183
2216,80000000,Animation,90463534,Space Jam,88,6.3,124368,10463534
2217,75000000,Action,134069511,The Rock,136,7.4,274324,59069511
2218,0,Drama,20754000,Fear,97,6.2,34037,20754000
2219,40000000,Crime,108766007,A Time to Kill,149,7.4,108790,68766007
2220,70000000,Comedy,37771017,Mars Attacks!,106,6.3,183327,-32228983
2221,4000000,Horror,16675000,Hellraiser: Bloodline,85,5.1,15579,12675000
2222,36000000,Biography,20191312,The People vs. Larry Flynt,129,7.3,76047,-15808688
2223,31000000,Comedy,124060553,The Birdcage,117,7.0,66577,93060553
2224,40000000,Horror,27663982,The Island of Dr. Moreau,96,4.4,27551,-12336018
2225,100000000,Animation,100138851,The Hunchback of Notre Dame,91,6.9,113772,138851
2226,25000000,Drama,7340103,The Crucible,124,6.8,30726,-17659897
2227,26000000,Comedy,25809813,That Thing You Do!,108,6.9,53448,-190187
2228,890000,Drama,24475416,Sling Blade,135,8.0,76760,23585416
2229,45000000,Action,92001027,First Contact,111,7.6,103044,47001027
2230,9000000,Drama,2038450,Crash: Extraños placeres,100,6.4,44693,-6961550
2231,55000000,Action,56569216,Executive Decision,133,6.4,43393,1569216
2232,45000000,Comedy,53854588,Tin Cup,135,6.3,40040,8854588
2233,7000000,Comedy,560069,Bottle Rocket,91,7.1,58644,-6439931
2234,15000000,Comedy,26757000,Bio-Dome,88,4.4,22728,11757000
2235,75000000,Adventure,136189294,101 Dalmatians,103,5.7,81872,61189294
2236,3800000,Comedy,20109115,Don't Be a Menace to South Central While Drinking Your Juice in the Hood,89,6.6,40789,16309115
2237,27000000,Comedy,24944213,Kingpin,113,6.9,67115,-2055787
2238,38000000,Animation,28934758,James and the Giant Peach,79,6.7,52633,-9065242
2239,4500000,Crime,3798532,Bound,108,7.4,43599,-701468
2240,40000000,Comedy,33109743,Striptease,115,4.3,36876,-6890257
2241,26000000,Comedy,105489203,The First Wives Club,103,6.2,34686,79489203
2242,8500000,Fantasy,15171475,Thinner,93,5.7,22170,6671475
2243,57000000,Action,51367375,DragonHeart,103,6.4,82032,-5632625
2244,54000000,Comedy,128814019,The Nutty Professor,95,5.6,92803,74814019
2245,0,Drama,2293037,El libro de cabecera,126,6.7,11067,2293037
2246,200000,Comedy,4505922,Swingers,96,7.3,67289,4305922
2247,47000000,Comedy,60240295,The Cable Guy,96,6.1,130570,13240295
2248,18000000,Drama,4414535,Hamlet,242,7.8,32078,-13585465
2249,30000000,Comedy,16759216,Muertos de miedo,110,7.1,71729,-13240784
2250,10000000,Drama,4573330,Stealing Beauty,118,6.6,21747,-5426670
2251,6000000,Comedy,22201883,Emma,120,6.7,29972,16201883
2252,0,Comedy,10597759,Beautiful Girls,112,7.2,27842,10597759
2253,50000000,Action,25477365,Escape from L.A.,101,5.7,58556,-24522635
2254,65000000,Action,33328051,The Long Kiss Goodnight,121,6.7,63699,-31671949
2255,0,Drama,4040691,Contra viento y marea,159,7.9,52366,4040691
2256,0,Comedy,95318203,Michael,105,5.7,36410,95318203
2257,45000000,Comedy,58620973,Jack,113,5.8,49346,13620973
2258,100000000,Action,101295562,Eraser,115,6.1,90008,1295562
2259,0,Comedy,11114000,2 Days in the Valley,104,6.5,16403,11114000
2260,50000000,Action,70770147,Broken Arrow,108,6.0,81083,20770147
2261,45000000,Comedy,20100000,Multiplicity,117,6.0,26196,-24900000
2262,9000000,Action,36049108,Set It Off,123,6.8,11203,27049108
2263,25000000,Sci-Fi,14048372,The Arrival,115,6.3,27641,-10951628
2264,55000000,Adventure,38619405,Garras,110,6.8,49044,-16380595
2265,4100000,Drama,11881039,Big Night,109,7.3,13983,7781039
2266,0,Action,22936273,D3: The Mighty Ducks,104,5.3,20543,22936273
2267,60000000,Comedy,60573641,Jingle All the Way,89,5.5,74318,573641
2268,31000000,Comedy,25785603,Down Periscope,92,6.0,18045,-5214397
2269,0,Crime,4440,Pusher,105,7.4,28650,4440
2270,80000000,Action,136492681,Ransom,121,6.6,104513,56492681
2271,55000000,Biography,50047179,Evita,135,6.3,30484,-4952821
2272,67000000,Action,17600000,Last Man Standing,101,6.4,47034,-49400000
2273,32000000,Drama,104636382,Phenomenon,123,6.4,66920,72636382
2274,23000000,Drama,12782508,Marvin's Room,98,6.7,21695,-10217492
2275,0,Comedy,46151454,One Fine Day,108,6.5,38106,46151454
2276,46000000,Action,59031057,Courage Under Fire,116,6.6,43118,13031057
2277,20000000,Comedy,9714482,Everyone Says I Love You,101,6.8,31731,-10285518
2278,3000000,Crime,222559,Hard Eight,102,7.3,31261,-2777441
2279,5500000,Biography,35811509,Claroscuro,105,7.7,45511,30311509
2280,80000000,Action,33023469,Daylight,114,5.8,56630,-46976531
2281,45000000,Action,17300889,The Phantom,100,4.9,28886,-27699111
2282,3300000,Biography,2961991,Basquiat,108,6.9,16846,-338009
2283,3500000,Comedy,9449219,She's the One,96,6.0,14689,5949219
2284,0,Action,3794000,Barb Wire,98,3.2,21707,3794000
2285,3000000,Comedy,295493,Freeway,104,6.9,23194,-2704507
2286,18000000,Comedy,26906039,Spy Hard,81,5.3,31561,8906039
2287,8000000,Drama,3594848,The Trigger Effect,94,5.7,5195,-4405152
2288,30000000,Action,21600000,The Quest,95,5.5,20369,-8400000
2289,55000000,Action,18573791,The Fan,116,5.8,40765,-36426209
2290,13000000,Comedy,5587855,Bordello of Blood,87,5.3,11251,-7412145
2291,4000000,Comedy,2923982,Waiting for Guffman,84,7.6,23604,-1076018
2292,0,Adventure,24506082,Fly Away Home,107,6.8,20777,24506082
2293,28000000,Biography,11092559,Michael Collins,133,7.1,25719,-16907441
2294,38000000,Adventure,10300000,White Squall,129,6.6,18875,-27700000
2295,0,Action,33609000,Muppet Treasure Island,99,6.9,17264,33609000
2296,0,Drama,258263,Foxfire,102,6.2,7419,258263
2297,4500000,Drama,13417292,Secrets & Lies,136,8.0,30816,8917292
2298,5000000,Drama,13269963,Lone Star,135,7.5,24495,8269963
2299,20000000,Comedy,18876581,Kazaam,93,2.8,20357,-1123419
2300,0,Drama,3692836,The Portrait of a Lady,144,6.3,9274,3692836
2301,20000000,Crime,26792700,Eye for an Eye,101,6.1,10968,6792700
2302,13000000,Action,17883659,The Crow: City of Angels,84,4.5,16707,4883659
2303,25000000,Action,21162420,Bulletproof,84,5.8,31241,-3837580
2304,36000000,Drama,13052741,Ghosts of Mississippi,130,6.7,8989,-22947259
2305,0,Comedy,32377000,Black Sheep,87,6.2,31582,32377000
2306,50000000,Action,20550712,Chain Reaction,107,5.6,42633,-29449288
2307,0,Drama,5200600,Jane Eyre,112,6.8,7988,5200600
2308,29000000,Crime,11500000,Mulholland Falls,107,6.2,13725,-17500000
2309,45000000,Action,20100000,The Glimmer Man,91,5.3,16419,-24900000
2310,0,Comedy,9871065,Dunston Checks In,88,5.3,10371,9871065
2311,42000000,Comedy,41252428,The Mirror Has Two Faces,126,6.5,12186,-747572
2312,0,Comedy,34073143,The Truth About Cats & Dogs,97,6.3,23091,34073143
2313,15000000,Comedy,21397954,A Very Brady Sequel,90,5.6,8733,6397954
2314,60000000,Drama,51088705,Up Close & Personal,124,6.1,11967,-8911295
2315,0,Adventure,49142277,Homeward Bound II: Lost in San Francisco,89,5.9,11514,49142277
2316,0,Comedy,1500000,Beautiful Thing,90,7.7,19792,1500000
2317,25530000,Family,20047715,Flipper,95,5.2,8610,-5482285
2318,40000000,Comedy,48102795,The Preacher's Wife,123,5.5,9355,8102795
2319,0,Comedy,12767815,The Evening Star,129,5.8,3609,12767815
2320,0,Drama,726207,SubUrbia,121,6.8,7747,726207
2321,0,Comedy,6970578,House Arrest,108,5.7,6920,6970578
2322,12000000,Animation,63071133,Beavis and Butt-Head Do America,81,6.8,45369,51071133
2323,13000000,Comedy,4611624,Joe's Apartment,80,5.4,11119,-8388376
2324,7000000,Horror,1055525,Bad Moon,80,5.7,4339,-5944475
2325,13000000,Comedy,26539321,Harriet the Spy,100,5.9,8449,13539321
2326,0,Comedy,19119165,Mother,104,6.9,4936,19119165
2327,0,Action,14752141,The Substitute,114,5.9,10051,14752141
2328,8000000,Comedy,34746109,A Thin Line Between Love and Hate,108,5.7,3427,26746109
2329,7000000,Comedy,14891000,Flirting with Disaster,92,6.8,15795,7891000
2330,44000000,Drama,22754725,The Juror,118,5.6,14796,-21245275
2331,39000000,Comedy,30356793,Sgt. Bilko,93,5.7,18726,-8643207
2332,0,Comedy,3102672,Feeling Minnesota,99,5.4,9478,3102672
2333,25000000,Action,14502483,Maximum Risk,101,5.4,16973,-10497517
2334,30000000,Comedy,8289972,Larger Than Life,93,5.6,5757,-21710028
2335,0,Action,15318863,Police Story 4: First Strike,107,6.6,16019,15318863
2336,21500000,Adventure,22294341,My Fellow Americans,101,6.5,12809,794341
2337,25000000,Adventure,15094530,The Adventures of Pinocchio,90,5.3,4408,-9905470
2338,7000000,Drama,405144,Jude,123,7.0,9046,-6594856
2339,0,Romance,19030691,Bed of Roses,87,6.1,7141,19030691
2340,0,Drama,17000000,Diabolique,107,5.3,11679,17000000
2341,47000000,Drama,5600000,Mary Reilly,108,5.8,12455,-41400000
2342,0,Comedy,2560471,Brassed Off,103,7.1,16640,2560471
2343,8000000,Comedy,5612586,The Pallbearer,98,5.0,7080,-2387414
2344,38000000,Crime,17305211,Extreme Measures,118,6.1,14855,-20694789
2345,0,Biography,14481231,In Love and War,113,6.0,7218,14481231
2346,1300000,Comedy,695229,Trees Lounge,95,7.2,11933,-604771
2347,3000000,Comedy,153155,Citizen Ruth,106,7.0,6170,-2846845
2348,35000000,Crime,8797839,Before and After,108,6.1,7142,-26202161
2349,0,Drama,1002175,Shiloh,93,6.4,2362,1002175
2350,0,Comedy,7874000,The Great White Hype,91,5.4,7621,7874000
2351,24000000,Comedy,6288000,Ed,94,2.6,7497,-17712000
2352,0,Family,26459681,First Kid,101,5.2,8148,26459681
2353,18000000,Drama,2780278,Unforgettable,117,6.0,4227,-15219722
2354,0,Crime,9881286,Night Falls on Manhattan,113,6.6,5463,9881286
2355,50000000,Crime,14551359,The Chamber,113,6.0,11040,-35448641
2356,15000000,Action,2409225,Lawnmower Man 2: Beyond Cyberspace,93,2.4,8315,-12590775
2357,0,Comedy,20951277,High School High,86,5.5,11343,20951277
2358,0,Adventure,72844,Mr. Toad's Wild Ride,88,6.3,2601,72844
2359,40000000,Drama,20200000,City Hall,111,6.2,17531,-19800000
2360,0,Comedy,12350030,Mr. Wrong,96,3.8,4465,12350030
2361,23000000,Adventure,11567023,Alaska,109,5.7,4485,-11432977
2362,0,Drama,3363968,Moll Flanders,123,6.5,3564,3363968
2363,5000000,Comedy,551545,Twelfth Night or What You Will,134,7.3,5003,-4448455
2364,25000000,Action,17100000,Fled,98,5.3,7433,-7900000
2365,0,Drama,4137645,To Gillian on Her 37th Birthday,93,5.8,4202,4137645
2366,12500000,Crime,1227324,The Funeral,99,6.6,7279,-11272676
2367,0,Drama,465417,Kissed,78,6.4,3213,465417
2368,12000000,Comedy,4903000,Girl 6,108,5.0,5191,-7097000
2369,2309723,Comedy,49620,Curdled,88,5.9,4334,-2260103
2370,22000000,Crime,1075288,Blood and Wine,101,6.1,8184,-20924712
2371,25000000,Drama,5005000,Heaven's Prisoners,132,5.7,4467,-19995000
2372,0,Comedy,12772657,The Associate,114,6.1,6473,12772657
2373,30000000,Comedy,31356117,Eddie,100,5.1,7525,1356117
2374,8000000,Comedy,80026,Mad Dog Time,93,5.5,2423,-7919974
2375,25000000,Comedy,2415593,The Stupids,94,4.1,5840,-22584407
2376,0,Mystery,516350,Boys,86,4.8,3143,516350
2377,25000000,Comedy,10070000,Mrs. Winterbourne,105,6.2,6054,-14930000
2378,0,Biography,1814290,I Shot Andy Warhol,103,6.6,5724,1814290
2379,0,Action,12491455,Black Mask,99,6.1,9730,12491455
2380,0,Crime,23107,The Sunchaser,122,6.2,3089,23107
2381,0,Animation,8620500,All Dogs Go to Heaven 2,82,5.5,4507,8620500
2382,5000000,Crime,326308,Albino Alligator,97,6.1,6912,-4673692
2383,0,Comedy,220198,Santa with Muscles,97,2.4,8063,220198
2384,500000,Comedy,502313,Manny & Lo,88,6.7,1549,2313
2385,17000000,Comedy,3308758,Carpool,89,4.9,3658,-13691242
2386,6000000,Drama,392362,Mother Night,114,7.2,4412,-5607638
2387,0,Comedy,10700000,Two If by Sea,96,5.2,4759,10700000
2388,0,Comedy,621093,The Van,100,6.8,3721,621093
2389,0,Comedy,720717,Box of Moon Light,112,7.3,4642,720717
2390,0,Drama,608032,Some Mother's Son,112,7.3,2238,608032
2391,0,Action,684351,Bloodsport 2,90,4.8,2498,684351
2392,0,Comedy,328452,The Eighth Day,118,7.6,7761,328452
2393,16000000,Biography,2002000,Surviving Picasso,125,6.4,6117,-13998000
2394,24000000,Comedy,592871,Two Much,118,5.4,4729,-23407129
2395,0,Adventure,1945552,Race the Sun,100,5.3,2772,1945552
2396,0,Drama,616663,It's My Party,110,7.1,2439,616663
2397,0,Comedy,2503829,Ridicule,102,7.5,6329,2503829
2398,0,Thriller,8538318,The Rich Man's Wife,95,5.2,2606,8538318
2399,0,Drama,290978,Carried Away,109,6.4,1340,290978
2400,30000000,Comedy,4357000,Bogus,110,5.3,5409,-25643000
2401,0,Comedy,1263945,Phat Beach,89,3.9,729,1263945
2402,0,Drama,44722,The War at Home,123,7.1,2003,44722
2403,0,Drama,315752,Caught,110,6.8,1003,315752
2404,19000000,Crime,1353824,Kansas City,116,6.3,3727,-17646176
2405,0,Comedy,32212,Head Above Water,92,6.0,6684,32212
2406,0,Comedy,32925,Love Is All There Is,100,5.1,1022,32925
2407,0,Comedy,2653000,Kids in the Hall: Brain Candy,89,6.9,7379,2653000
2408,0,Comedy,196927,A Summer's Tale,113,7.7,4597,196927
2409,0,Comedy,9255027,Celtic Pride,91,5.2,8709,9255027
2410,0,Drama,454720,La Promesse,100,7.9,5849,454720
2411,5000000,Comedy,4635344,If Lucy Fell,92,4.9,3510,-364656
2412,7000000,Drama,106606,The Secret Agent,95,5.8,1986,-6893394
2413,0,Comedy,191164,Irma Vep,99,7.0,3909,191164
2414,0,Drama,5858000,Last Dance,103,5.8,3503,5858000
2415,0,Comedy,9676677,Shall We Dance?,136,7.8,9603,9676677
2416,6000000,Drama,12643776,The Spitfire Grill,117,6.9,4971,6643776
2417,19000000,Action,4932915,Solo,94,3.9,3629,-14067085
2418,0,Drama,883973,Female Perversions,119,5.5,2064,883973
2419,0,Comedy,1007306,Mystery Science Theater 3000: The Movie,73,7.4,16362,1007306
2420,200000000,Drama,658672302,Titanic,194,7.8,862554,458672302
2421,10000000,Drama,138433435,Good Will Hunting,126,8.3,675871,128433435
2422,93000000,Action,63540020,The Fifth Element,126,7.7,371054,-29459980
2423,80000000,Action,17626234,The Postman,177,6.0,59758,-62373766
2424,85000000,Animation,99046791,Hercules,93,7.2,159637,14046791
2425,20000000,Comedy,57598247,Life Is Beautiful,116,8.6,476021,37598247
2426,105000000,Action,54814377,Starship Troopers,129,7.2,235069,-50185623
2427,90000000,Drama,100920329,Contact,150,7.4,217655,10920329
2428,62000000,Drama,1400000,Lolita,137,6.9,41536,-60600000
2429,75000000,Action,101117573,Con Air,115,6.8,239462,26117573
2430,15000000,Drama,26400640,Boogie Nights,155,7.9,201945,11400640
2431,90000000,Adventure,250690539,Men in Black,98,7.3,438633,160690539
2432,35000000,Crime,64616940,L.A. Confidential,138,8.3,448833,29616940
2433,125000000,Action,107325195,Batman & Robin,125,3.7,202339,-17674805
2434,80000000,Action,112225777,Face/Off,138,7.3,302052,32225777
2435,50000000,Drama,48323648,The Game,129,7.8,285147,-1676352
2436,36000000,Drama,12339633,Gattaca,106,7.8,238316,-23660367
2437,0,Animation,2375308,Princess Mononoke,134,8.4,252409,2375308
2438,57000000,Drama,60984028,The Devil's Advocate,144,7.5,279086,3984028
2439,17000000,Horror,72586134,I Know What You Did Last Summer,101,5.6,112994,55586134
2440,12000000,Crime,39673162,Jackie Brown,154,7.5,257809,27673162
2441,75000000,Action,47748610,Alien Resurrection,109,6.2,191097,-27251390
2442,73000000,Action,229086679,The Lost World: Jurassic Park,129,6.5,305054,156086679
2443,60000000,Horror,26673242,Event Horizon,96,6.7,130640,-33326758
2444,110000000,Action,125332007,Tomorrow Never Dies,119,6.5,157749,15332007
2445,50000000,Animation,58406347,Anastasia,94,7.1,94409,8406347
2446,90000000,Action,49323468,Volcano,104,5.4,62450,-40676532
2447,35000000,Biography,41909762,Donnie Brasco,127,7.8,239317,6909762
2448,50000000,Comedy,148478011,As Good as It Gets,139,7.7,238028,98478011
2449,17000000,Adventure,53883989,Austin Powers: International Man of Mystery,94,7.0,193479,36883989
2450,15000000,Mystery,3796699,Por el lado oscuro del camino,134,7.6,107530,-11203301
2451,40000000,Crime,45856732,The Rainmaker,135,7.1,50025,5856732
2452,45000000,Comedy,181410615,Liar Liar,86,6.8,237870,136410615
2453,0,Drama,501818,El cubo,90,7.3,174546,501818
2454,116000000,Action,67127760,Dante's Peak,108,5.9,67277,-48872240
2455,20000000,Biography,35422828,Selena,127,6.7,20575,15422828
2456,40000000,Action,54967359,Spawn,96,5.2,56225,14967359
2457,46000000,Comedy,127120029,My Best Friend's Wedding,105,6.3,106240,81120029
2458,0,Action,27779888,The Edge,117,6.9,59422,27779888
2459,24000000,Horror,101363301,Scream 2,120,6.1,133216,77363301
2460,0,Comedy,29205077,Romy and Michele's High School Reunion,92,6.2,36016,29205077
2461,0,Biography,9217930,Mrs Brown,101,7.3,11598,9217930
2462,45000000,Action,65885767,Anaconda,89,4.7,79593,20885767
2463,1300000,Comedy,19820,Gummo,89,6.7,26360,-1280180
2464,36000000,Drama,44175394,Amistad,155,7.3,60668,8175394
2465,55000000,Action,105263257,George of the Jungle,92,5.4,60243,50263257
2466,85000000,Action,172956409,Air Force One,124,6.5,155674,87956409
2467,30000000,Horror,25480490,Mimic,105,5.9,39195,-4519510
2468,32000000,Comedy,30882515,Home Alone 3,102,4.3,83369,-1117485
2469,1000000,Comedy,582024,Orgazmo,94,6.2,31548,-417976
2470,22000000,Adventure,45319423,Bean,89,6.4,81315,23319423
2471,0,Animation,112536,Perfect Blue,81,7.9,33789,112536
2472,70000000,Adventure,37957682,Seven Years in Tibet,136,7.0,103750,-32042318
2473,180000,Drama,925402,Children of Heaven,89,8.4,37590,745402
2474,15000000,Action,28014536,Grosse Pointe Blank,107,7.4,77687,13014536
2475,50000000,Action,48169156,G.I. Jane,125,5.9,64233,-1830844
2476,3500000,Comedy,45950122,The Full Monty,91,7.2,86993,42450122
2477,27000000,Crime,60527873,Kiss the Girls,115,6.6,54408,33527873
2478,250000,Comedy,12006514,Chasing Amy,113,7.3,119658,11756514
2479,25000000,Comedy,29342592,Spice World,93,3.4,29357,4342592
2480,50000000,Action,50007168,Absolute Power,121,6.7,42417,7168
2481,30000000,Action,35927406,Mortal Kombat: Annihilation,95,3.7,38860,5927406
2482,10000000,Crime,44886089,Cop Land,105,6.9,73991,34886089
2483,35000000,Comedy,63856929,In & Out,90,6.3,33955,28856929
2484,0,Drama,368234,Open Your Eyes,117,7.8,56004,368234
2485,18000000,Drama,7837632,The Ice Storm,112,7.5,48479,-10162368
2486,60000000,Action,54930280,The Jackal,124,6.4,92834,-5069720
2487,19000000,Crime,6633400,Camino sin retorno,125,6.8,44133,-12366600
2488,20000000,Biography,41198146,Private Parts,109,6.8,30718,21198146
2489,9000000,Comedy,23687907,Good Burger,95,5.7,22284,14687907
2490,35000000,Crime,25078937,Midnight in the Garden of Good and Evil,155,6.6,33319,-9921063
2491,15000000,Comedy,43022524,Wag the Dog,97,7.1,70832,28022524
2492,68000000,Action,61355436,The Saint,116,6.2,54546,-6644564
2493,160000000,Action,48608066,Speed 2: Cruise Control,121,3.8,64186,-111391934
2494,25000000,Comedy,36429528,Vegas Vacation,93,5.9,36231,11429528
2495,86000000,Action,42868348,The Devil's Own,111,6.1,49303,-43131652
2496,75000000,Action,75982834,Conspiracy Theory,135,6.7,81477,982834
2497,29000000,Adventure,22359293,The Borrowers,89,5.8,17334,-6640707
2498,32000000,Comedy,59925026,Jungle 2 Jungle,105,5.1,19393,27925026
2499,36000000,Action,50129186,Breakdown,93,6.9,40913,14129186
2500,80000000,Comedy,92977226,Flubber,93,5.2,69813,12977226
2501,38000000,Comedy,61917389,Mousehunt,98,6.4,44226,23917389
2502,0,Comedy,29291566,Fools Rush In,109,6.0,28959,29291566
2503,0,Comedy,15448043,RocketMan,95,5.9,7750,15448043
2504,10000000,Comedy,31058643,Picture Perfect,105,5.5,16867,21058643
2505,50000000,Action,41263140,The Peacemaker,124,5.9,48476,-8736860
2506,30000000,Crime,23461013,Hoodlum,130,6.3,8947,-6538987
2507,16000000,Action,1710972,Steel,97,2.8,9291,-14289028
2508,0,Drama,5799672,The Boxer,113,7.1,15417,5799672
2509,10000000,Biography,2157701,Wilde,118,6.9,13004,-7842299
2510,0,Drama,5936344,Inventing the Abbotts,110,6.4,10037,5936344
2511,22000000,Comedy,26570463,An American Werewolf in Paris,105,5.1,20220,4570463
2512,5000000,Fantasy,15719109,Wishmaster,90,5.7,16368,10719109
2513,0,Drama,1535558,Live Flesh,103,7.4,24283,1535558
2514,0,Action,31235710,Beverly Hills Ninja,88,5.5,32904,31235710
2515,60000000,Action,16228448,Fire Down Below,105,5.0,14530,-43771552
2516,3000000,Comedy,24629916,Air Bud,98,5.1,13907,21629916
2517,40000000,Horror,33956608,The Relic,110,5.7,20582,-6043392
2518,0,Comedy,5479037,Gridlock'd,91,7.0,12516,5479037
2519,7500000,Comedy,43490057,Soul Food,115,7.0,5761,35990057
2520,25000000,Action,41067398,Money Talks,97,6.2,23799,16067398
2521,37000000,Crime,6482195,Switchback,118,6.4,10585,-30517805
2522,1000000,Fantasy,125397,The Night Flier,94,6.0,7849,-874603
2523,20000000,Comedy,10569071,Deconstructing Harry,96,7.4,37690,-9430929
2524,25000000,Action,44455658,Nothing to Lose,98,6.7,38128,19455658
2525,28000000,Biography,5532301,Kundun,134,7.0,22853,-22467699
2526,0,Comedy,861789,The Castle,85,7.7,12748,861789
2527,0,Drama,3252652,Dulce porvenir,112,7.7,28237,3252652
2528,0,Crime,233986,Fireworks,103,7.9,22758,233986
2529,30000000,Action,11438337,Double Team,93,4.7,26927,-18561663
2530,0,Comedy,13960203,How to Be a Player,93,5.3,2520,13960203
2531,0,Action,7324662,Wild America,106,6.3,5751,7324662
2532,20000000,Action,14327206,Excess Baggage,101,5.3,11399,-5672794
2533,0,Comedy,7240837,B*A*P*S,91,4.1,3000,7240837
2534,1000000,Comedy,1950218,Two Girls and a Guy,84,5.6,6203,950218
2535,12000000,Comedy,4266243,A Life Less Ordinary,103,6.4,31471,-7733757
2536,35000000,Drama,791830,Anna Karenina,108,6.4,4851,-34208170
2537,0,Drama,187508,Happy Together,96,7.8,16820,187508
2538,12000000,Crime,4052347,Playing God,94,5.6,6643,-7947653
2539,35000000,Action,6448817,Warriors of Virtue,100,4.6,2372,-28551183
2540,48000000,Crime,22415440,Red Corner,122,6.3,13892,-25584560
2541,0,Comedy,20060051,Booty Call,79,5.3,6739,20060051
2542,20000000,Action,13801755,The Man Who Knew Too Little,94,6.6,25388,-6198245
2543,25000000,Action,13104494,Rosewood,140,7.2,6487,-11895506
2544,18000000,Drama,7221836,Sin embargo es adorable,100,5.9,7334,-10778164
2545,0,Crime,221173,Insomnia,96,7.3,10989,221173
2546,25000000,Comedy,9381260,Fierce Creatures,93,6.4,20507,-15618740
2547,0,Drama,372341,Bent,105,7.3,6690,372341
2548,0,Action,25826788,Murder at 1600,107,6.1,24953,25826788
2549,0,Action,5790448,Gang Related,100,6.5,6559,5790448
2550,0,Drama,1200000,Nightwatch,101,6.2,16972,1200000
2551,0,Action,540063,The Assignment,119,6.9,7830,540063
2552,5000000,Comedy,1692872,Suicide Kings,106,7.0,23526,-3307128
2553,0,Comedy,27354,Nowhere,82,6.4,7092,27354
2554,0,Comedy,13600,Fever Pitch,102,6.7,8885,13600
2555,8000000,Biography,532190,Prefontaine,106,6.8,6161,-7467810
2556,0,Action,12674183,Mr. Nice Guy,97,6.2,21377,12674183
2557,0,Comedy,247745,The Real Blonde,105,6.0,3547,247745
2558,28000000,Comedy,8119205,A Simple Wish,89,5.4,4549,-19880795
2559,0,Comedy,34656904,Addicted to Love,100,6.1,20829,34656904
2560,30000000,Adventure,21382456,Mr. Magoo,87,3.9,12708,-8617544
2561,20000000,Drama,5716080,One Eight Seven,119,6.7,19216,-14283920
2562,0,Drama,207751,Bliss,103,6.1,1775,207751
2563,0,Action,3296,Knockin' on Heaven's Door,87,8.0,22387,3296
2564,32000000,Animation,3562749,Cats Don't Dance,75,6.9,6006,-28437251
2565,6000000,Drama,6302154,Affliction,114,7.0,12633,302154
2566,0,Drama,14036249,FairyTale: A True Story,99,6.5,4935,14036249
2567,6000000,Drama,14821531,Eve's Bayou,109,7.3,7316,8821531
2568,8000000,Action,8109349,Turbo: A Power Rangers Movie,99,3.5,7129,109349
2569,0,Drama,13718385,The Wings of the Dove,102,7.2,9287,13718385
2570,50000000,Crime,10556196,Mad City,100,6.2,17297,-39443804
2571,3300000,Comedy,74188,Twin Town,99,6.7,4995,-3225812
2572,0,Adventure,3519178,Free Willy 3: The Rescue,86,4.6,7706,3519178
2573,55000000,Action,31987563,Metro,117,5.5,22499,-23012437
2574,9000000,Drama,339648,Welcome to Sarajevo,103,6.9,6194,-8660352
2575,17000000,Comedy,3506206,The Pest,84,5.0,7038,-13493794
2576,35000000,Action,2221994,Smilla's Sense of Snow,121,6.4,12197,-32778006
2577,5000000,Drama,20733485,The Apostle,134,7.2,12029,15733485
2578,24000000,Drama,2618335,One Night Stand,102,5.8,5888,-21381665
2579,0,Drama,7928412,A Thousand Acres,105,6.0,4550,7928412
2580,85000000,Comedy,28659604,Fathers' Day,98,5.1,12880,-56340396
2581,0,Comedy,27974168,Out to Sea,106,6.1,6714,27974168
2582,0,Crime,572433,Deceiver,106,6.7,5368,572433
2583,0,Drama,311873,Taste of Cherry,95,7.7,16565,311873
2584,35000000,Comedy,31611225,For Richer or Poorer,115,5.7,8578,-3388775
2585,1500000,Comedy,617403,The House of Yes,85,6.7,6947,-882597
2586,0,Action,18301610,That Darn Cat,89,4.6,3491,18301610
2587,0,Comedy,13548764,Trial and Error,98,5.7,5446,13548764
2588,0,Crime,94596,The Cure,111,7.4,7133,94596
2589,3000000,Comedy,3559990,8 Heads in a Duffel Bag,95,5.3,8398,559990
2590,10000000,Drama,10200000,The Spanish Prisoner,110,7.3,19466,200000
2591,53000000,Comedy,19736932,Gone Fishin',94,4.7,8375,-33263068
2592,8000000,Crime,1495332,City of Industry,97,6.2,5078,-6504668
2593,0,Fantasy,6086891,Kull the Conqueror,95,4.8,6906,6086891
2594,15000000,Comedy,309,Trojan War,84,5.7,5034,-14999691
2595,11000000,Comedy,14708874,The Sixth Man,107,5.6,4735,3708874
2596,0,Adventure,7183046,Zeus and Roxanne,98,5.3,2472,7183046
2597,31190000,Action,4529843,McHale's Navy,108,4.4,5716,-26660157
2598,10000000,Drama,12514138,Love Jones,104,7.4,3076,2514138
2599,25000,Comedy,2856622,In the Company of Men,97,7.3,11992,2831622
2600,15000000,Comedy,10713605,Leave It to Beaver,84,5.1,3396,-4286395
2601,0,Comedy,3376403,The MatchMaker,97,6.5,4943,3376403
2602,12000000,Adventure,7015240,Star Kid,101,5.4,2065,-4984760
2603,16000000,Comedy,11486880,The Beautician and the Beast,105,5.3,7153,-4513120
2604,0,Adventure,10005081,Buddy,84,4.8,2217,10005081
2605,7000000,Drama,106292,Lawn Dogs,101,7.6,6638,-6893708
2606,18000000,Comedy,3247524,A Smile Like Yours,98,4.8,1230,-14752476
2607,0,Comedy,71145,Plump Fiction,82,2.7,3363,71145
2608,1000000,Romance,3478370,'Til There Was You,113,4.8,2415,2478370
2609,16000000,Drama,1921471,Paradise Road,122,6.8,4496,-14078529
2610,0,Action,1890472,Masterminds,106,5.2,3058,1890472
2611,0,Comedy,86175,Going All the Way,103,5.7,1681,86175
2612,2700000,Drama,9054736,Ulee's Gold,113,7.1,5988,6354736
2613,0,Drama,3263672,Mrs Dalloway,97,6.9,3065,3263672
2614,0,Comedy,1822193,The Butcher Boy,110,7.2,8238,1822193
2615,45000000,Action,2154540,Shadow Conspiracy,103,4.9,3969,-42845460
2616,71000000,Action,11466088,Turbulence,100,4.8,9453,-59533912
2617,25000000,Action,6320276,Most Wanted,99,5.5,5089,-18679724
2618,0,Drama,2280573,Ma Vie en Rose,88,7.6,7811,2280573
2619,0,Comedy,1338335,Henry Fool,137,7.3,6214,1338335
2620,0,Action,5079851,Dangerous Ground,95,4.5,1686,5079851
2621,0,Drama,1508689,Oscar and Lucinda,132,6.7,5898,1508689
2622,3000000,Comedy,302204,Shooting Fish,109,6.6,6880,-2697796
2623,5000000,Drama,283033,The End of Violence,122,5.6,4321,-4716967
2624,0,Comedy,26347,Eight Days a Week,92,6.3,2705,26347
2625,4000000,Biography,46362,The Last Time I Committed Suicide,92,5.8,1776,-3953638
2626,0,Comedy,673153,The Crazy Stranger,102,7.7,6529,673153
2627,0,Crime,19140,The Manson Family,95,5.5,2764,19140
2628,0,Drama,1710693,Washington Square,115,6.7,2838,1710693
2629,0,Comedy,287752,Mr. Jealousy,103,6.5,1607,287752
2630,0,Romance,784419,Firelight,103,7.3,3638,784419
2631,10000000,Comedy,45779,An Alan Smithee Film: Burn Hollywood Burn,86,3.5,3055,-9954221
2632,0,Comedy,11690,Breaking Up,90,4.9,2387,11690
2633,0,Drama,283081,Amy Foster,115,6.9,2496,283081
2634,0,Drama,33556,Digging to China,98,6.9,2228,33556
2635,0,Comedy,444354,Clockwatchers,96,6.5,4165,444354
2636,0,Comedy,212267,Still Breathing,109,6.9,2050,212267
2637,0,Action,54154,"Truth or Consequences, N.M.",106,6.3,4266,54154
2638,4500000,Crime,713413,Character,122,7.8,9512,-3786587
2639,0,Comedy,592573,Star Maps,86,5.9,893,592573
2640,70000000,Drama,216540909,Saving Private Ryan,169,8.6,979007,146540909
2641,15000000,Comedy,17451873,The Big Lebowski,117,8.2,592823,2451873
2642,7500000,Crime,6719864,American History X,119,8.5,857333,-780136
2643,90000000,Animation,120620254,Mulan,88,7.6,193214,30620254
2644,140000000,Action,201573391,Armageddon,151,6.6,344203,61573391
2645,60000000,Comedy,125618201,The Truman Show,103,8.1,740961,65618201
2646,0,Comedy,3650677,"Lock, Stock and Two Smoking Barrels",107,8.2,450149,3650677
2647,60000,Drama,3216970,Pi,84,7.5,151309,3156970
2648,23000000,Comedy,176484651,There's Something About Mary,119,7.1,259794,153484651
2649,45000000,Action,70087718,Blade,120,7.1,206719,25087718
2650,25000000,Comedy,32383850,Bride of Chucky,89,5.4,42757,7383850
2651,0,Adventure,66308518,The Parent Trap,128,6.5,96539,66308518
2652,90000000,Drama,44619100,Meet Joe Black,178,7.1,180700,-45380900
2653,48000000,Comedy,46683377,Practical Magic,104,6.2,60149,-1316623
2654,60000000,Action,32940507,Mercury Rising,111,6.1,57649,-27059493
2655,52000000,Drama,36400491,The Thin Red Line,170,7.6,148812,-15599509
2656,27000000,Mystery,14378331,Ciudad en tinieblas,100,7.7,166822,-12621669
2657,20000000,Crime,29753944,Wild Things,108,6.5,95388,9753944
2658,55000000,Action,41616262,Ronin,122,7.3,152869,-13383738
2659,18500000,Adventure,10680275,Fear and Loathing in Las Vegas,118,7.7,226427,-7819725
2660,25000000,Comedy,100317794,Shakespeare in Love,123,7.2,187035,75317794
2661,33000000,Action,141153686,Rush Hour,98,6.9,201905,108153686
2662,65000000,Comedy,115821495,You've Got Mail,119,6.6,163612,50821495
2663,20000000,Comedy,161491646,The Waterboy,90,6.1,127466,141491646
2664,75000000,Action,140464664,Deep Impact,120,6.1,142094,65464664
2665,80000000,Action,69117629,Lost in Space,130,5.1,61386,-10882371
2666,120000000,Animation,162798565,A Bug's Life,95,7.2,226736,42798565
2667,9000000,Comedy,17105219,Rushmore,93,7.7,144975,8105219
2668,70000000,Animation,101217900,The Prince of Egypt,99,7.0,98359,31217900
2669,15000000,Horror,40064955,The Faculty,104,6.4,96886,25064955
2670,90000000,Action,111549836,Enemy of the State,132,7.3,199848,21549836
2671,85000000,Drama,55485043,What Dreams May Come,113,7.0,88728,-29514957
2672,48000000,Crime,37562568,Out of Sight,123,7.0,75099,-10437432
2673,20000000,Action,20241395,Vampires,108,6.1,45366,241395
2674,65000000,Action,94095523,The Mask of Zorro,136,6.7,144796,29095523
2675,35000000,Action,56968902,The Man in the Iron Mask,132,6.5,134842,21968902
2676,26000000,Comedy,65705771,Ever After: A Cinderella Story,121,7.0,61035,39705771
2677,18000000,Comedy,80245725,The Wedding Singer,95,6.8,116558,62245725
2678,60000000,Horror,21456130,Psycho,105,4.6,39983,-38543870
2679,17000000,Horror,55041738,Halloween H20: 20 Years Later,86,5.7,52529,38041738
2680,70000000,Action,74329966,Six Days Seven Nights,98,5.8,64070,4329966
2681,0,Action,25188006,Fallen,124,7.0,62957,25188006
2682,0,Drama,1053788,Velvet Goldmine,118,7.0,29251,1053788
2683,15000000,Horror,17411331,Perturbados,84,5.5,18255,2411331
2684,130000000,Action,136314294,Godzilla,139,5.3,160038,6314294
2685,40000000,Comedy,40568025,Pleasantville,124,7.5,108475,568025
2686,30000000,Drama,60053195,Hope Floats,114,5.9,20726,30053195
2687,60000000,Action,14567883,Soldier,99,6.0,46241,-45432117
2688,40000000,Action,54682547,Small Soldiers,108,6.1,81216,14682547
2689,12000000,Crime,22905674,Rounders,121,7.4,128159,10905674
2690,10000000,Comedy,25339117,Can't Hardly Wait,100,6.5,39581,15339117
2691,60000000,Action,57167405,U.S. Marshals,131,6.5,82606,-2832595
2692,6000,Crime,48482,Following,69,7.6,72113,42482
2693,30000000,Biography,30082699,Elizabeth,124,7.5,80195,82699
2694,25000000,Drama,26333044,Great Expectations,111,6.8,45205,1333044
2695,8000000,Comedy,17278980,Half Baked,82,6.7,50868,9278980
2696,14000000,Horror,38072438,Urban Legend,99,5.5,50594,24072438
2697,58000000,Action,70117571,Star Trek: Insurrection,103,6.4,60249,12117571
2698,28000000,Action,13979599,Blues Brothers 2000,123,4.8,27480,-14020401
2699,17000000,Comedy,30324946,A Night at the Roxbury,82,6.2,50769,13324946
2700,50000000,Comedy,91137662,Stepmom,124,6.7,50401,41137662
2701,140000000,Action,130444603,Lethal Weapon 4,127,6.6,135019,-9555397
2702,90000000,Biography,135026902,Patch Adams,115,6.7,86765,45026902
2703,60000000,Action,23322832,The Avengers,89,3.7,36811,-36677168
2704,71500000,Comedy,144156605,Doctor Dolittle,85,5.3,79986,72656605
2705,105000000,Animation,90757863,Antz,83,6.6,131396,-14242137
2706,0,Crime,7267585,Run Lola Run,81,7.7,169466,7267585
2707,0,Comedy,6940185,BASEketball,103,6.6,50796,6940185
2708,73000000,Crime,55585389,Snake Eyes,98,6.0,67384,-17414611
2709,50000000,Action,44484065,El mediador,140,7.3,113865,-5515935
2710,24000000,Horror,40002112,I Still Know What You Did Last Summer,100,4.6,58906,16002112
2711,66000000,Drama,83898313,The X Files,121,7.0,90546,17898313
2712,14000000,Crime,8838938,Apt Pupil,111,6.7,30742,-5161062
2713,3000000,Comedy,2807390,Happiness,134,7.8,58551,-192610
2714,55000000,Drama,78685114,Un ángel enamorado,114,6.7,100012,23685114
2715,13000000,Drama,16574731,54,93,5.8,28791,3574731
2716,1500000,Comedy,2375097,Buffalo '66,110,7.5,39256,875097
2717,60000000,Crime,67638368,A Perfect Murder,107,6.5,68263,7638368
2718,9000000,Comedy,11883495,Sliding Doors,99,6.8,55546,2883495
2719,80000000,Drama,37020277,Sphere,134,6.0,87413,-42979723
2720,70000000,Action,40981289,The Siege,116,6.3,61043,-29018711
2721,10000000,Drama,9473382,The Red Violin,130,7.7,28172,-526618
2722,60000000,Drama,75383563,The Horse Whisperer,170,6.6,34250,15383563
2723,0,Crime,14096321,Les Misérables,134,7.5,33810,14096321
2724,8000000,Biography,4530929,Dangerous Beauty,111,7.3,13477,-3469071
2725,9000000,Drama,259127,The Legend of 1900,165,8.1,45151,-8740873
2726,30000000,Action,18967571,The Replacement Killers,87,6.1,24291,-11032429
2727,24000000,Animation,100494675,The Rugrats Movie,79,5.9,15183,76494675
2728,30000000,Comedy,26525834,Bulworth,108,6.8,22893,-3474166
2729,1300000,Drama,1647780,The Celebration,105,8.1,69371,347780
2730,10000000,Comedy,9801782,Very Bad Things,100,6.3,41062,-198218
2731,85000000,Comedy,34545030,Jack Frost,101,5.3,26466,-50454970
2732,0,Comedy,168761,Show Me Love,89,7.6,44663,168761
2733,4500000,Comedy,23031390,The Players Club,104,5.7,4688,18531390
2734,25000000,Drama,21554585,He Got Game,136,6.9,38487,-3445415
2735,0,Comedy,29767901,Madeline,88,5.9,5579,29767901
2736,0,Comedy,299200,SLC Punk!,97,7.5,23282,299200
2737,13000000,Comedy,9975684,Dirty Work,82,6.4,20926,-3024316
2738,45000000,Action,11203026,Deep Rising,106,6.0,28083,-33796974
2739,0,Crime,54735,I Stand Alone,93,7.5,15508,54735
2740,0,Action,19165560,Species II,93,4.3,23941,19165560
2741,17000000,Crime,16311763,A Simple Plan,121,7.5,54106,-688237
2742,2500000,Comedy,7235,Los idiotas,117,6.9,25714,-2492765
2743,30000000,Drama,23245840,One True Thing,127,7.0,9970,-6754160
2744,13000000,Action,27052167,The Big Hit,91,6.1,25792,14052167
2745,40000000,Animation,22717758,The Magic Sword: Quest for Camelot,86,6.2,12174,-17282242
2746,30000000,Comedy,18252684,Simon Birch,114,6.9,19073,-11747316
2747,90000000,Action,50632037,Mighty Joe Young,114,5.6,24374,-39367963
2748,27000000,Action,10297897,The Newton Boys,122,6.0,8995,-16702103
2749,2000000,Comedy,6719300,Smoke Signals,89,7.2,8559,4719300
2750,0,Action,268254,Taxi,86,6.9,65651,268254
2751,3000000,Crime,9630169,Belly,96,6.0,7666,6630169
2752,12000000,Comedy,5032496,Celebrity,113,6.3,21644,-6967504
2753,5000000,Comedy,5881367,The Opposite of Sex,105,6.5,18791,881367
2754,0,Action,3121,Thursday,83,7.2,14875,3121
2755,0,Comedy,219932,Sour Grapes,91,5.7,2482,219932
2756,75000000,Drama,56702901,A Civil Action,115,6.5,24412,-18297099
2757,0,Horror,5657370,Phantoms,96,5.4,17167,5657370
2758,30000000,Animation,85744662,Pokémon: The First Movie - Mewtwo Strikes Back,96,6.0,32118,55744662
2759,15000000,Comedy,29106737,The Object of My Affection,111,6.0,16506,14106737
2760,0,Comedy,348660,"Black Cat, White Cat",127,8.1,43614,348660
2761,70000000,Action,19819494,Hard Rain,97,5.8,28397,-50180506
2762,3500000,Biography,6390032,Gods and Monsters,105,7.5,26050,2890032
2763,0,Adventure,18912328,The Odd Couple II,97,6.4,7798,18912328
2764,5000000,Comedy,5480318,Slums of Beverly Hills,91,6.6,10079,480318
2765,6000000,Comedy,2281761,Pecker,87,6.4,12098,-3718239
2766,14000000,Comedy,3956212,Playing by Heart,121,7.2,17129,-10043788
2767,20000000,Comedy,37672350,How Stella Got Her Groove Back,124,5.6,5794,17672350
2768,0,Drama,13513622,Hush,96,5.3,8036,13513622
2769,80000000,Drama,22852487,Beloved,172,5.9,6354,-57147513
2770,3000000,Comedy,24788807,Waking Ned Devine,91,7.3,22433,21788807
2771,0,Comedy,2643689,The Mighty,100,7.3,11035,2643689
2772,65000000,Comedy,38966057,Escándalo,143,6.7,24802,-26033943
2773,50000000,Action,13806137,Desperate Measures,100,6.1,14476,-36193863
2774,0,Comedy,968506,All I Wanna Do,97,6.7,5895,968506
2775,0,Comedy,4065116,The Dinner Game,80,7.7,31717,4065116
2776,30000000,Adventure,6114928,Almost Heroes,90,5.8,13764,-23885072
2777,0,Action,12829351,Black Dog,89,5.3,7181,12829351
2778,10000000,Comedy,19882538,Mafia!,87,5.5,13168,9882538
2779,80000000,Adventure,18319860,Babe el puerquito va a la ciudad,97,5.8,26946,-61680140
2780,18000000,Comedy,3551208,Major League: Back to the Minors,100,4.5,6102,-14448792
2781,0,Drama,1929168,High Art,101,6.7,8834,1929168
2782,8000000,Comedy,2987297,The Last Days of Disco,113,6.6,10509,-5012703
2783,14000000,Comedy,15062898,Dead Man on Campus,96,6.1,12255,1062898
2784,0,Comedy,1200000,Cousin Bette,108,6.2,2259,1200000
2785,0,Drama,8288513,Return to Paradise,111,6.9,12128,8288513
2786,0,Comedy,2100000,Kuch Kuch Hota Hai,177,7.8,37960,2100000
2787,25000000,Thriller,1534569,The Gingerbread Man,114,5.7,9583,-23465431
2788,20000000,Crime,15030732,Twilight,94,6.2,8769,-4969268
2789,25000000,Biography,777423,Without Limits,117,7.2,6061,-24222577
2790,4500000,Crime,1025234,Another Day in Paradise,101,6.5,7508,-3474766
2791,0,Comedy,1200000,Get Real,108,7.7,11131,1200000
2792,1100000,Horror,631221,Strangeland,85,5.0,5935,-468779
2793,0,Action,9623329,Acusado sin razón,87,6.1,19731,9623329
2794,15000000,Comedy,13035599,Senseless,93,6.0,11375,-1964401
2795,35000000,Action,10076136,Knock Off,91,4.8,12179,-24923864
2796,23000000,Adventure,27008669,Paulie,91,6.5,12531,4008669
2797,0,Drama,15814088,Dance with Me,126,5.8,5146,15814088
2798,0,Comedy,1796328,Hurlyburly,122,5.8,9261,1796328
2799,20000000,Action,2147114,Tarzan and the Lost City,100,3.9,1892,-17852886
2800,0,Comedy,142783,The Acid House,111,6.3,6281,142783
2801,12000000,Adventure,1262786,Hideous Kinky,98,6.1,5757,-10737214
2802,7000000,Comedy,258212,Wide Awake,88,6.1,3440,-6741788
2803,0,Action,375805,3 Ninjas: High Noon at Mega Mountain,93,2.8,9353,375805
2804,0,Comedy,4595000,Little Voice,97,7.0,14479,4595000
2805,15000000,Adventure,11144518,Barney's Great Adventure,76,2.9,2827,-3855482
2806,2900000,Drama,5595428,Central Station,113,8.0,30487,2695428
2807,0,Comedy,477903,Still Crazy,95,7.1,6735,477903
2808,0,Biography,343023,Love Is the Devil: Study for a Portrait of Francis Bacon,87,6.4,2881,343023
2809,0,Comedy,215553,Homegrown,102,5.8,4164,215553
2810,0,Crime,5840581,El secreto,114,6.0,6906,5840581
2811,60000000,Comedy,12065985,Holy Man,114,4.9,17120,-47934015
2812,0,Drama,106486,Eternity and a Day,137,7.9,7269,106486
2813,5000000,Comedy,1980338,Zero Effect,116,7.0,12839,-3019662
2814,0,Biography,1211865,The General,124,7.3,7076,1211865
2815,0,Comedy,306715,Chairman of the Board,100,2.3,5356,306715
2816,19000000,Thriller,8041665,Firestorm,89,4.6,3270,-10958335
2817,0,Drama,504223,Lovers of the Arctic Circle,112,7.8,16017,504223
2818,0,Comedy,7985929,My Giant,103,4.9,5996,7985929
2819,7000000,Biography,4874838,Hilary and Jackie,121,7.4,8950,-2125162
2820,0,Drama,20416,New Rose Hotel,93,4.9,3666,20416
2821,0,Drama,378667,Head On,104,6.4,3473,378667
2822,30000000,Comedy,12213678,I'll Be Home for Christmas,86,5.4,7267,-17786322
2823,6000000,Drama,9122,Hell's Kitchen,95,4.9,2209,-5990878
2824,0,Comedy,4002640,Kissing a Fool,100,5.6,4457,4002640
2825,0,Crime,6198916,La jugada,94,7.2,16569,6198916
2826,0,Crime,1242,I Want You,87,6.3,2483,1242
2827,700000,Comedy,870751,Edge of Seventeen,99,6.8,4954,170751
2828,0,Comedy,10215386,Air Bud: Golden Receiver,90,4.5,4556,10215386
2829,0,Biography,1166199,Permanent Midnight,88,6.3,6246,1166199
2830,0,Biography,12413650,Why Do Fools Fall in Love,116,6.3,3123,12413650
2831,5000000,Comedy,4710749,Your Friends & Neighbors,100,6.4,7208,-289251
2832,8000000,Comedy,1789892,Clay Pigeons,104,6.6,9721,-6210108
2833,0,Comedy,2197921,The Impostors,101,6.5,4553,2197921
2834,0,Drama,121875,The Proposition,110,6.3,1883,121875
2835,0,Drama,801985,After Life,100,7.7,7680,801985
2836,0,Comedy,30229,Free Enterprise,113,7.0,2954,30229
2837,20000000,Comedy,1923061,Goodbye Lover,102,5.7,3012,-18076939
2838,0,Crime,34524,B. Monkey,92,6.0,3044,34524
2839,0,Drama,146083,The Land Girls,111,6.3,1680,146083
2840,1000000,Comedy,21210,Safe Men,88,6.0,2851,-978790
2841,0,Comedy,7514883,Krippendorf's Tribe,94,4.9,4748,7514883
2842,15000000,Comedy,10443316,Home Fries,91,5.0,7388,-4556684
2843,24000000,Comedy,4308981,Meet the Deedles,93,3.9,2385,-19691019
2844,13000000,Comedy,8026971,Woo,84,3.9,1586,-4973029
2845,0,Comedy,258464,Twice Upon a Yesterday,91,6.4,2134,258464
2846,2000000,Action,124494,Six-String Samurai,91,6.7,5956,-1875506
2847,0,Comedy,5476059,Ride,90,4.5,606,5476059
2848,0,Animation,113484,Rudolph the Red-Nosed Reindeer,100,5.8,1851,113484
2849,0,Drama,1000000,Xiu Xiu: The Sent-Down Girl,99,7.5,2816,1000000
2850,0,Drama,163810,The Hi-Lo Country,114,6.1,3807,163810
2851,0,Crime,21404,Immortality,98,6.3,5180,21404
2852,0,Drama,346696,My Name Is Joe,105,7.5,6574,346696
2853,3500000,Comedy,9247881,Ringmaster,90,3.2,4578,5747881
2854,0,Comedy,34488,Slappy and the Stinkers,78,5.0,898,34488
2855,0,Comedy,154790,Train of Life,103,7.7,7735,154790
2856,10000000,Drama,12903,Savior,103,7.3,9097,-9987097
2857,800000,Comedy,343229,West Beirut,105,7.8,2545,-456771
2858,0,Drama,2285194,Dancing at Lughnasa,95,6.3,3045,2285194
2859,0,Drama,528972,Earth,110,7.8,6310,528972
2860,63000000,Drama,37030102,Fight Club,139,8.8,1492073,-25969898
2861,15000000,Drama,130096601,American Beauty,122,8.4,899755,115096601
2862,63000000,Action,171479930,The Matrix,136,8.7,1339820,108479930
2863,60000000,Crime,136801374,The Green Mile,189,8.5,879924,76801374
2864,11000000,Comedy,102561004,American Pie,95,7.0,332271,91561004
2865,65000000,Drama,55691208,Eyes Wide Shut,159,7.3,246014,-9308792
2866,80000000,Action,155247825,The Mummy,124,7.0,340714,75247825
2867,40000000,Drama,293506292,The Sixth Sense,107,8.1,766528,253506292
2868,30000000,Comedy,38176108,10 Things I Hate About You,97,7.2,244103,8176108
2869,100000000,Fantasy,101071502,Sleepy Hollow,105,7.4,284929,1071502
2870,115000000,Action,474544677,Star Wars: Episode I - The Phantom Menace,136,6.5,584809,359544677
2871,60000000,Action,73648142,Deep Blue Sea,105,5.8,105864,13648142
2872,10000000,Comedy,10824921,Enredos de oficina,89,7.8,212640,824921
2873,6000000,Drama,4859475,The Virgin Suicides,97,7.2,125166,-1140525
2874,10500000,Drama,38328567,Cruel Intentions,97,6.8,157466,27828567
2875,45000000,Adventure,71583916,Galaxy Quest,102,7.3,130142,26583916
2876,37000000,Drama,22455976,Magnolia,188,8.0,253771,-14544024
2877,33000000,Action,206040086,Austin Powers: The Spy Who Shagged Me,95,6.6,191205,173040086
2878,25000000,Comedy,55474756,Never Been Kissed,107,6.0,72371,30474756
2879,7000000,Action,25812,The Boondock Saints,108,7.9,206785,-6974188
2880,40000000,Biography,28871190,"Girl, Interrupted",127,7.4,135410,-11128810
2881,90000000,Animation,245852179,Toy Story 2,92,7.9,420432,155852179
2882,40000000,Crime,81298265,The Talented Mr. Ripley,139,7.3,148622,41298265
2883,170000000,Action,113805681,Wild Wild West,106,4.8,136482,-56194319
2884,42000000,Comedy,116089678,Notting Hill,124,7.1,220588,74089678
2885,60000,Horror,140539099,The Blair Witch Project,81,6.4,202691,140479099
2886,13000000,Comedy,22858926,Being John Malkovich,112,7.8,270071,9858926
2887,34200000,Comedy,163479795,Big Daddy,93,6.4,171997,129279795
2888,10000000,Comedy,63366989,She's All That,95,5.8,71905,53366989
2889,135000000,Action,126943684,The World Is Not Enough,128,6.4,165433,-8056316
2890,100000000,Action,66889043,End of Days,121,5.7,94188,-33110957
2891,10000000,Adventure,30651422,Dogma,130,7.4,189591,20651422
2892,130000000,Animation,171091819,Tarzan,88,7.2,160561,41091819
2893,16000000,Comedy,52885587,Varsity Blues,106,6.4,37062,36885587
2894,82000000,Biography,34580635,Man on the Moon,118,7.4,105653,-47419365
2895,66000000,Action,87704396,Entrapment,113,6.3,93659,21704396
2896,70000000,Animation,23159305,The Iron Giant,86,8.0,140243,-46840695
2897,17000000,Comedy,65538755,Deuce Bigalow: Male Gigolo,88,5.7,62761,48538755
2898,48000000,Crime,69304264,The Thomas Crown Affair,113,6.8,76693,21304264
2899,12000000,Fantasy,2060953,Voraz,101,7.0,31991,-9939047
2900,80000000,Comedy,63844974,Life,108,6.7,36302,-16155026
2901,25000000,Biography,32481825,October Sky,108,7.8,69372,7481825
2902,68000000,Biography,28965197,The Insider,157,7.9,141001,-39034803
2903,75000000,Action,60652036,Three Kings,114,7.1,145142,-14347964
2904,38000000,Mystery,18661336,La última puerta,133,6.7,144875,-19338664
2905,55000000,Drama,75530832,Any Given Sunday,162,6.8,101796,20530832
2906,100000000,Comedy,58220776,Bicentennial Man,132,6.8,94773,-41779224
2907,55000000,Comedy,66384775,Bowfinger,97,6.4,59541,11384775
2908,0,Horror,2840417,eXistenZ: Mundo virtual,97,6.8,82097,2840417
2909,2000000,Biography,11533945,Boys Don't Cry,118,7.6,81901,9533945
2910,160000000,Action,32698899,The 13th Warrior,102,6.6,105423,-127301101
2911,3500000,Comedy,3071947,Jawbreaker,87,5.5,20256,-428053
2912,73000000,Crime,66518655,The Bone Collector,118,6.7,129642,-6481345
2913,70000000,Crime,116741558,Double Jeopardy,105,6.4,60299,46741558
2914,10000000,Biography,6203044,The Straight Story,112,8.0,68583,-3796956
2915,25000000,Comedy,14879556,Election,103,7.3,77515,-10120444
2916,68000000,Action,29655590,Mystery Men,121,6.1,56155,-38344410
2917,15000000,Comedy,10561238,Drop Dead Gorgeous,97,6.6,28434,-4438762
2918,24000000,Drama,57545092,The Cider House Rules,126,7.4,83170,33545092
2919,35000000,Action,31770414,Lake Placid,82,5.6,46036,-3229586
2920,12000000,Horror,21133087,Stir of Echoes,99,7.0,65477,9133087
2921,80000000,Fantasy,91411151,La maldición,113,4.9,61842,11411151
2922,133000000,Adventure,140035367,"Stuart Little, un ratón en la familia",84,5.9,103603,7035367
2923,35000000,Comedy,26494611,Blast from the Past,112,6.6,52177,-8505389
2924,90000000,Action,81526121,Payback,100,7.1,117618,-8473879
2925,20000000,Comedy,16842303,Go,102,7.3,61476,-3157697
2926,50000000,Biography,50668906,The Hurricane,146,7.6,81047,668906
2927,40000000,Mystery,36663315,8MM,123,6.5,109400,-3336685
2928,37000000,Horror,40846082,House on Haunted Hill,93,5.6,47381,3846082
2929,95000000,Crime,102705852,The General's Daughter,116,6.3,45376,7705852
2930,21000000,Animation,52008288,"South Park: Bigger, Longer & Uncut",81,7.8,171511,31008288
2931,75000000,Drama,10672566,The Astronaut's Wife,109,5.3,47987,-64327434
2932,0,Drama,8264530,All About My Mother,101,7.9,74742,8264530
2933,0,Drama,1282941,Romance,84,5.3,8516,1282941
2934,0,Action,3308029,Ghost dog - El camino del samurai,116,7.5,74739,3308029
2935,16000000,Mystery,15500000,El piso 13,100,7.0,56325,-500000
2936,0,Comedy,4764741,Mansfield Park,112,7.1,18079,4764741
2937,25000000,Comedy,4002955,Idle Hands,92,6.2,35197,-20997045
2938,28000000,Comedy,8888143,"Mystery, Alaska",119,6.7,23089,-19111857
2939,11000000,Comedy,16071990,A Midsummer Night's Dream,116,6.5,22127,5071990
2940,25000000,Drama,10114315,Brokedown Palace,100,6.4,19516,-14885685
2941,70000000,Comedy,152257509,Runaway Bride,116,5.5,79935,82257509
2942,22000000,Crime,19283782,Summer of Sam,142,6.6,32454,-2716218
2943,6500000,Comedy,4217115,Detroit Rock City,95,6.8,31824,-2282885
2944,55000000,Drama,16640210,Bringing Out the Dead,121,6.8,55769,-38359790
2945,85000000,Adventure,14276317,The Messenger: The Story of Joan of Arc,158,6.4,58412,-70723683
2946,21000000,Horror,17762705,The Rage: Carrie 2,104,4.6,13693,-3237295
2947,80000000,Comedy,106885658,Analyze This,103,6.7,130447,26885658
2948,1200000,Comedy,2205627,But I'm a Cheerleader,85,6.6,21306,1005627
2949,80000000,Drama,52880016,Message in a Bottle,126,6.2,31045,-27119984
2950,29000000,Horror,50046268,Stigmata,103,6.2,57128,21046268
2951,0,Drama,172107,Pola X,134,5.8,3763,172107
2952,0,Comedy,2011254,Better Than Chocolate,101,6.2,6963,2011254
2953,0,Drama,1921350,Titus,162,7.2,18033,1921350
2954,90000000,Action,97403112,Inspector Gadget,78,4.1,38883,7403112
2955,15000000,Comedy,4485485,Flawless,112,6.4,15402,-10514515
2956,8500000,Comedy,17845337,Drive Me Crazy,91,5.7,15840,9345337
2957,80000000,Drama,35168395,For Love of the Game,137,6.6,27499,-44831605
2958,65000000,Action,68518533,Blue Streak,93,6.3,64009,3518533
2959,34000000,Comedy,30628981,Superstar,81,5.0,15732,-3371019
2960,13000000,Comedy,6241697,Dick,94,6.1,16661,-6758303
2961,80000000,Animation,60655420,Fantasia 2000,100,7.2,29666,-19344580
2962,0,Comedy,104257,Human Traffic,99,7.1,20316,104257
2963,31000000,Crime,24362501,Arlington Road,117,7.2,73152,-6637499
2964,35000000,Comedy,27797271,The Other Sister,129,6.5,10870,-7202729
2965,92000000,Drama,39263420,Anna and the King,148,6.7,32493,-52736580
2966,20000000,Comedy,8276228,The Love Letter,88,5.4,3641,-11723772
2967,75000000,Comedy,52888180,Forces of Nature,105,5.4,28258,-22111820
2968,9000000,Comedy,34102780,The Best Man,120,6.7,7086,25102780
2969,50000000,Drama,13038660,Angela's Ashes,145,7.3,17953,-36961340
2970,23000000,Drama,10660147,The End of the Affair,102,7.2,18698,-12339853
2971,55000000,Crime,16635339,True Crime,127,6.6,27145,-38364661
2972,30000000,Crime,4155234,Gloria,108,5.1,4711,-25844766
2973,80000000,Comedy,22362500,Edtv,122,6.1,37180,-57637500
2974,80000000,Drama,34098563,Instinct,126,6.5,28633,-45901437
2975,64000000,Drama,31054924,Random Hearts,133,5.1,17776,-32945076
2976,6000000,Comedy,25047631,The Wood,106,6.9,7032,19047631
2977,75000000,Action,14010690,Virus,99,4.9,23127,-60989310
2978,9000000,Crime,3193102,The Limey,89,7.1,25899,-5806898
2979,12000000,Comedy,27141959,Baby Geniuses,97,2.6,21192,15141959
2980,14000000,Drama,4741987,A Walk on the Moon,107,6.6,7083,-9258013
2981,0,Drama,254441,The War Zone,98,7.4,8458,254441
2982,14000000,Comedy,18535191,An Ideal Husband,97,6.9,13547,4535191
2983,50000000,Comedy,27067160,The Story of Us,95,5.9,19215,-22932840
2984,24000000,Comedy,8427204,Play It to the Bone,124,5.4,10533,-15572796
2985,33000000,Comedy,8406264,Pushing Tin,124,6.0,25713,-24593736
2986,0,Adventure,1644060,Asterix and Obelix vs. Caesar,109,5.9,33214,1644060
2987,0,Drama,5095981,Sunshine,181,7.5,11708,5095981
2988,0,Comedy,4170647,East Is East,96,6.9,15294,4170647
2989,38000000,Drama,13376506,The Deep End of the Ocean,106,6.3,11136,-24623494
2990,6000000,Comedy,4394936,Simplemente irresistible,96,5.3,11965,-1605064
2991,29750000,Comedy,4196621,Sweet and Lowdown,95,7.3,29088,-25553379
2992,75000000,Comedy,33864342,Mickey Blue Eyes,102,5.8,31178,-41135658
2993,0,Drama,1758780,Holy Smoke,115,5.9,12682,1758780
2994,27000000,Drama,14859394,Music of the Heart,124,6.8,10622,-12140606
2995,6000000,Comedy,6851636,200 Cigarettes,101,5.9,13466,851636
2996,23000000,Comedy,18653615,Anywhere But Here,114,6.2,15423,-4346385
2997,13000000,Comedy,8946237,Teaching Mrs. Tingle,96,5.2,17917,-4053763
2998,0,Crime,368808,The Minus Man,111,6.2,5765,368808
2999,65000000,Comedy,36830057,My Favorite Martian,94,5.0,11414,-28169943
3000,45000000,Drama,4956401,Jakob the Liar,120,6.5,13320,-40043599
3001,13000000,Action,10037390,Godzilla 2000,99,6.1,5994,-2962610
3002,60000000,Drama,22365133,At First Sight,128,5.9,11819,-37634867
3003,35000000,Drama,630779,Ride with the Devil,138,6.8,11587,-34369221
3004,15000000,Comedy,1954202,Crazy in Alabama,111,6.3,6108,-13045798
3005,28000000,Comedy,4554569,Mumford,112,6.9,8298,-23445431
3006,12000000,Drama,14348123,Tea with Mussolini,117,6.9,9745,2348123
3007,45000000,Action,10431220,Universal Soldier: The Return,83,4.1,25272,-34568780
3008,3000000,Comedy,9016377,Trippin',94,5.2,1043,6016377
3009,0,Animation,94591,Jin-Roh: The Wolf Brigade,102,7.5,12129,94591
3010,4000000,Comedy,2800000,Love Stinks,94,5.8,4508,-1200000
3011,26000000,Adventure,11634458,The Adventures of Elmo in Grouchland,73,5.8,2304,-14365542
3012,51000000,Comedy,21731001,The Bachelor,101,5.0,15339,-29268999
3013,30000000,Animation,43758684,Pokémon: The Movie 2000,84,6.0,16683,13758684
3014,0,Drama,239894,Body Shots,106,5.0,4983,239894
3015,24000000,Adventure,16625807,Muppets from Space,87,6.3,15619,-7374193
3016,0,Biography,6201757,Topsy-Turvy,154,7.4,10484,6201757
3017,7000000,Comedy,7292175,Outside Providence,96,6.4,7949,292175
3018,35000000,Drama,16459004,Eye of the Beholder,109,4.9,13676,-18540996
3019,25000000,Action,15156200,The Corruptor,110,6.0,15959,-9843800
3020,0,Comedy,417517,8 ½ Women,118,5.8,3474,417517
3021,0,Adventure,1810145,The Color of Paradise,90,8.2,12452,1810145
3022,8500000,Comedy,10919177,Cookie's Fortune,118,6.9,11540,2419177
3023,35000000,Drama,14378353,Snow Falling on Cedars,127,6.8,12701,-20621647
3024,30000,Drama,216781,Ratcatcher,94,7.5,6648,186781
3025,7000000,Crime,25651,Best Laid Plans,92,6.2,6562,-6974349
3026,450000,Comedy,2049595,Trick,89,7.2,7252,1599595
3027,0,Drama,247606,Beau Travail,92,7.4,5833,247606
3028,4000000,Drama,399793,The Loss of Sexual Innocence,106,5.4,2940,-3600207
3029,20000000,Comedy,10544143,Three to Tango,98,6.1,16906,-9455857
3030,5000000,Action,97152,Swiri,125,6.7,7224,-4902848
3031,0,Drama,3150107,The Big Kahuna,90,6.7,12697,3150107
3032,0,Comedy,3742,Coming Soon,96,4.4,1364,3742
3033,30000000,Action,11576087,Wing Commander,100,4.2,15148,-18423913
3034,30000000,Drama,12017369,In Dreams,100,5.5,11323,-17982631
3035,25000000,Animation,11956538,The King and I,87,4.1,3209,-13043462
3036,0,Biography,927107,Aimee & Jaguar,125,7.3,5439,927107
3037,7000000,Crime,14003141,In Too Deep,95,6.2,4935,7003141
3038,0,Comedy,80226,Julien Donkey-Boy,94,6.7,5692,80226
3039,0,Drama,261475,Rosetta,95,7.6,10176,261475
3040,0,Drama,198238,Kikujiro,121,7.9,15585,198238
3041,12000000,Comedy,175370,Breakfast of Champions,110,4.6,7081,-11824630
3042,75000000,Comedy,28535768,The Out-of-Towners,90,5.3,11242,-46464232
3043,12000000,Crime,5241315,Black & White,98,5.0,5216,-6758685
3044,0,Action,474900,Plunkett & Macleane,99,6.4,8908,474900
3045,32000000,Drama,2899970,Cradle Will Rock,132,6.9,8237,-29100030
3046,50000000,Action,13260050,The Mod Squad,92,4.2,7995,-36739950
3047,2500000,Drama,1282084,Jesus' Son,107,7.0,6425,-1217916
3048,70000000,Comedy,9694105,Dudley Do-Right,77,3.9,8641,-60305895
3049,30000000,Comedy,6545360,Lost & Found,95,5.0,5807,-23454640
3050,30000000,Biography,632617,Grey Owl,100,6.0,2996,-29367383
3051,5250000,Horror,10155690,Bats,91,3.7,8632,4905690
3052,10000000,Action,292152,Rescate explosivo,85,2.5,6187,-9707848
3053,15000000,Comedy,11614236,The Muse,97,5.6,9648,-3385764
3054,500000,Comedy,1434,Terror Firmer,114,6.3,4225,-498566
3055,70000000,Action,11227940,Chill Factor,102,5.2,8600,-58772060
3056,14000000,Drama,206128,Onegin,106,6.9,6629,-13793872
3057,0,Comedy,3676,Suits,88,4.2,146,3676
3058,0,Comedy,18434,A Room for Romeo Brass,90,7.7,4755,18434
3059,21000000,Comedy,15593,Molly,102,5.8,2410,-20984407
3060,0,Comedy,43865,Virtual Sexuality,92,5.0,2608,43865
3061,0,Comedy,1708496,The Girl on the Bridge,90,7.6,11570,1708496
3062,0,Drama,213253,The Wind Will Carry Us,118,7.6,6191,213253
3063,0,Comedy,45703,Splendor,93,5.9,2740,45703
3064,1700000,Comedy,1943649,"Happy, Texas",98,6.3,8911,243649
3065,0,Drama,3732398,Liberty Heights,127,7.1,5945,3732398
3066,0,Comedy,140426,Agnes Browne,92,6.6,1858,140426
3067,0,Drama,36025,Whiteboyz,92,5.3,1606,36025
3068,10000000,Drama,902144,Simpatico,106,4.5,3075,-9097856
3069,0,Biography,616310,My Life So Far,98,6.5,2573,616310
3070,0,Drama,461493,Marcel Proust's Time Regained,100,6.8,1927,461493
3071,0,Musical,2005094,Hum Saath-Saath Hain: We Stand United,100,6.2,4789,2005094
3072,0,Action,1841,Dead or Alive,105,6.9,6387,1841
3073,0,Drama,3956112,The Winslow Boy,104,7.4,6669,3956112
3074,0,Drama,1280090,The Road Home,89,7.9,10983,1280090
3075,0,Drama,113495,Humanité,148,6.9,3105,113495
3076,0,Drama,94633,Friends & Lovers,100,4.5,1330,94633
3077,312000,Drama,1281176,Tumbleweeds,102,6.7,3018,969176
3078,0,Drama,544538,A Map of the World,125,6.7,3659,544538
3079,7500000,Action,12614346,The Omega Code,100,3.5,4762,5114346
3080,4500000,Drama,3609278,Requiem for a Dream,102,8.3,630161,-890722
3081,103000000,Action,187705427,Gladiator,155,8.5,1081122,84705427
3082,7000000,Crime,15070285,American Psycho,102,7.6,391018,8070285
3083,110000000,Action,113330342,The Patriot,165,7.2,221478,3330342
3084,9000000,Mystery,25544867,Memento,113,8.5,929360,16544867
3085,0,Comedy,30328156,Snatch,104,8.3,654846,30328156
3086,30000000,Biography,115654751,Remember the Titans,113,7.8,171757,85654751
3087,75000000,Drama,95011339,Unbreakable,106,7.2,280513,20011339
3088,60000000,Adventure,32534850,Almost Famous,122,7.9,220062,-27465150
3089,90000000,Adventure,233632142,Cast Away,143,7.8,429806,143632142
3090,75000000,Action,157299717,X-Men,104,7.4,493164,82299717
3091,95000000,Action,73209340,Hollow Man,112,5.7,107767,-21790660
3092,19000000,Comedy,157019771,Scary Movie,88,6.2,199176,138019771
3093,50000000,Adventure,39785027,The Beach,119,6.6,191504,-10214973
3094,100000000,Drama,155464351,What Lies Beneath,130,6.6,103332,55464351
3095,0,Comedy,3429045,Malèna,109,7.5,71752,3429045
3096,23000000,Horror,53331147,Final Destination,98,6.7,194181,30331147
3097,93000000,Action,125305545,Charlie's Angels,98,5.5,153010,32305545
3098,16000000,Adventure,68540777,Road Trip,93,6.5,140390,52540777
3099,26000000,Adventure,45506619,"O Brother, Where Art Thou?",107,7.8,242380,19506619
3100,90000000,Action,101648571,Gone in Sixty Seconds,118,6.5,230823,11648571
3101,33000000,Horror,61334059,The Cell,107,6.3,84206,28334059
3102,17000000,Action,128078872,"Crouching Tiger, Hidden Dragon",120,7.9,228025,111078872
3103,123000000,Comedy,260044825,How the Grinch Stole Christmas,104,6.0,155553,137044825
3104,100000000,Adventure,60883407,Mission to Mars,114,5.6,63522,-39116593
3105,125000000,Action,215409889,Mission: Impossible II,123,6.1,260493,90409889
3106,11000000,Comedy,68379000,Bring It On,98,6.0,74635,57379000
3107,52000000,Biography,125595205,Erin Brockovich,131,7.3,145443,73595205
3108,0,Drama,2734044,In the Mood for Love,98,8.1,86800,2734044
3109,45000000,Action,106807667,Miss Congeniality,109,6.2,150621,61807667
3110,25000000,Drama,71509363,Chocolat,121,7.3,158788,46509363
3111,70000000,Comedy,182811707,What Women Want,127,6.4,169079,112811707
3112,85000000,Comedy,39464775,Little Nicky,90,5.3,85512,-45535225
3113,48000000,Crime,124115725,Traffic,147,7.6,177611,76115725
3114,45000000,Comedy,60786269,Coyote Ugly,100,5.6,95297,15786269
3115,100000000,Animation,89302687,The Emperor's New Groove,78,7.3,141885,-10697313
3116,73000000,Action,21471685,Battlefield Earth,118,2.4,68160,-51528315
3117,95000000,Animation,50863742,The Road to El Dorado,89,6.9,65786,-44136258
3118,23000000,Horror,39240659,Pitch Black,109,7.1,203269,16240659
3119,50000000,Comedy,44737059,The Replacements,118,6.5,50976,-5262941
3120,5000000,Drama,21995263,Billy Elliot,110,7.7,104498,16995263
3121,2000000,Drama,5383834,Amores Perros,154,8.1,187814,3383834
3122,30000000,Comedy,27277055,High Fidelity,113,7.5,150311,-2722945
3123,51000000,Comedy,90570999,"Me, Myself & Irene",116,6.6,196521,39570999
3124,0,Comedy,21172,Bootmen,100,6.3,2022,21172
3125,6000000,Comedy,18621249,Best in Show,90,7.5,48351,12621249
3126,12800000,Crime,4184036,Bailando en la oscuridad,140,8.0,85318,-8615964
3127,127500000,Animation,137748063,Dinosaur,82,6.5,42134,10248063
3128,0,Crime,6946056,Sexy Beast,89,7.3,46274,6946056
3129,48000000,Comedy,37879996,Bedazzled,93,6.0,86122,-10120004
3130,55000000,Comedy,166244045,Meet the Parents,108,7.0,275232,111244045
3131,40000000,Horror,89138076,Scream 3,116,5.5,105236,49138076
3132,31000000,Crime,45010278,Frequency,118,7.4,87828,14010278
3133,45000000,Animation,106834564,Chicken Run,84,7.0,150396,61834564
3134,32000000,Biography,48818921,Men of Honor,129,7.2,94931,16818921
3135,140000000,Action,182618434,The Perfect Storm,130,6.4,139439,42618434
3136,46000000,Action,70334258,Shaft,99,5.9,61511,24334258
3137,41300000,Comedy,57262492,The Whole Nine Yards,98,6.7,95357,15962492
3138,80000000,Drama,34592089,Thirteen Days,145,7.3,47719,-45407911
3139,40000000,Drama,33519628,Pay It Forward,123,7.2,101554,-6480372
3140,13500000,Biography,7060876,Quills,124,7.3,46715,-6439124
3141,13000000,Comedy,46729800,"Dude, Where's My Car?",83,5.5,121888,33729800
3142,15000000,Comedy,33771174,Where the Heart Is,120,6.8,28510,18771174
3143,7000000,Crime,16938179,Boiler Room,120,7.0,43830,9938179
3144,83000000,Comedy,35268275,The Flintstones in Viva Rock Vegas,90,3.6,16842,-47731725
3145,84000000,Comedy,123309890,Nutty Professor II: The Klumps,106,4.3,41835,39309890
3146,29000000,Drama,17174870,Center Stage,115,6.7,16575,-11825130
3147,11000000,Comedy,57328603,Next Friday,98,6.1,30194,46328603
3148,10000000,Drama,12008642,The Gift,112,6.7,55272,2008642
3149,60000000,Comedy,75793305,The Family Man,125,6.7,90612,15793305
3150,5000000,Drama,2554,Feroz,108,6.8,35413,-4997446
3151,80000000,Drama,30695227,The Legend of Bagger Vance,126,6.7,48043,-49304773
3152,62000000,Action,77086030,U-571: La batalla del Atlántico,116,6.6,68714,15086030
3153,29000000,Comedy,37047880,Keeping the Faith,128,6.4,46213,8047880
3154,55000000,Action,56937502,Shanghai Noon,110,6.6,103550,1937502
3155,57000000,Drama,15527125,All the Pretty Horses,116,5.8,11851,-41472875
3156,30000000,Action,117559438,Big Momma's House,99,5.1,71163,87559438
3157,0,Drama,33410,Maelstrom,87,7.2,3631,33410
3158,65000000,Action,90464773,Space Cowboys,130,6.4,63698,25464773
3159,82000000,Action,34604280,The 6th Day,123,5.9,104775,-47395720
3160,43000000,Comedy,37170488,28 Days,103,6.0,37015,-5829512
3161,0,Crime,5793,Rape Me,77,4.5,15237,5793
3162,75000000,Action,69243859,Vertical Limit,124,5.9,52111,-5756141
3163,38000000,Crime,13019253,The Crew,88,5.6,4108,-24980747
3164,20000000,Drama,27441122,Love & Basketball,124,7.2,15454,7441122
3165,25000000,Action,55973336,Romeo Must Die,115,6.1,59814,30973336
3166,0,Biography,234259,Chopper,94,7.2,32850,234259
3167,1200000,Drama,9180275,You Can Count on Me,111,7.7,24362,7980275
3168,54000000,Action,33022767,Dracula 2000,99,4.9,28622,-20977233
3169,65000000,Drama,37752931,Autumn in New York,103,5.5,21504,-27247069
3170,43000000,Drama,51804714,Finding Forrester,136,7.3,75692,8804714
3171,75000000,Animation,22751979,Titan A.E.,94,6.6,54115,-52248021
3172,8000000,Drama,8279017,Shadow of the Vampire,92,6.9,35600,279017
3173,32000000,Comedy,8735529,Whatever It Takes,94,5.5,8432,-23264471
3174,45000000,Action,15220685,Dungeons & Dragons,107,3.6,28683,-29779315
3175,76000000,Animation,26000610,The Adventures of Rocky & Bullwinkle,92,4.2,17406,-49999390
3176,0,Biography,4221817,Antes que anochezca,133,7.3,21732,4221817
3177,60000000,Drama,61335230,Rules of Engagement,128,6.4,39436,1335230
3178,42000000,Action,23360779,Reindeer Games,104,5.7,33094,-18639221
3179,80000000,Action,17480890,Red Planet,106,5.7,49905,-62519110
3180,85000000,Adventure,66957026,102 Dalmatians,100,4.8,28524,-18042974
3181,35000000,Adventure,13555988,The Little Vampire,95,5.7,7879,-21444012
3182,10000000,Drama,139692,Tigerland,101,7.0,34628,-9860308
3183,20000000,Comedy,15618626,Loser,98,5.3,23989,-4381374
3184,90000000,Horror,14218868,Supernova,90,4.8,15330,-75781132
3185,25000000,Crime,258691,Bajo sospecha,110,6.5,19265,-24741309
3186,55000000,Comedy,19389454,Wonder Boys,107,7.4,56555,-35610546
3187,65000000,Comedy,69691949,The Kid,104,6.1,36128,4691949
3188,63600000,Action,14967182,Get Carter,102,5.1,28856,-48632818
3189,24000000,Comedy,32662299,Return to Me,115,6.9,17212,8662299
3190,1500000,Crime,1221261,Nine Queens,114,7.9,41658,-278739
3191,15000000,Adventure,26437094,Book of Shadows: Blair Witch 2,90,4.0,31565,11437094
3192,24000000,Crime,882710,The Yards,115,6.4,17187,-23117290
3193,65000000,Action,32598931,Proof of Life,135,6.2,50964,-32401069
3194,24000000,Comedy,12372410,Ready to Rumble,107,5.3,12277,-11627590
3195,30000000,Crime,28927720,The Watcher,97,5.3,23123,-1072280
3196,35000000,Action,35007180,The Skulls,106,5.6,28112,7180
3197,6000000,Biography,8596914,Pollock,122,7.0,24202,2596914
3198,10000000,Comedy,12115757,Saving Grace,93,6.9,16011,2115757
3199,14000000,Drama,3060963,Beautiful,112,5.4,3378,-10939037
3200,0,Crime,632548,The Crimson Rivers,106,6.9,51306,632548
3201,8500000,Action,6055661,The Way of the Gun,119,6.7,28466,-2444339
3202,6000000,Comedy,34099640,My Dog Skip,95,7.0,17398,28099640
3203,23000000,Comedy,13113041,Dr. T & the Women,122,4.6,16174,-9886959
3204,19000000,Adventure,15911333,Thomas and the Magic Railroad,85,3.7,3106,-3088667
3205,60000000,Comedy,36050230,Hanging Up,94,4.8,10627,-23949770
3206,35000000,Comedy,20627372,Boys and Girls,94,5.4,14393,-14372628
3207,25000000,Action,12801190,Highlander: Endgame,87,4.6,17216,-12198810
3208,0,Drama,1136776,Yi Yi,173,8.1,14617,1136776
3209,35000000,Comedy,20035310,Down to You,91,4.9,12868,-14964690
3210,16000000,Crime,102622,The Weight of Water,100,5.9,7993,-15897378
3211,24000000,Comedy,13592872,The Ladies Man,84,5.1,11223,-10407128
3212,25000000,Comedy,17071230,Small Time Crooks,94,6.7,32888,-7928770
3213,20000000,Drama,17872723,The Contender,126,7.0,21189,-2127277
3214,60000000,Action,30208599,The Art of War,117,5.7,26180,-29791401
3215,10000000,Comedy,2185266,Bamboozled,135,6.5,9042,-7814734
3216,0,Drama,739583,The Man Who Cried,100,6.2,13051,739583
3217,13000000,Adventure,60020107,Snow Day,89,5.0,9929,47020107
3218,0,Comedy,2252970,The Dish,101,7.2,13427,2252970
3219,0,Crime,30915,Gangster No. 1,103,6.8,11520,30915
3220,30000000,Animation,76507756,Rugrats in Paris: The Movie,78,6.1,8974,46507756
3221,14000000,Horror,21468807,Leyenda urbana 2,97,4.1,13751,7468807
3222,35000000,Drama,36779296,Bounce,106,5.7,18326,1779296
3223,24000000,Drama,5108820,Gossip,90,5.9,13017,-18891180
3224,65000000,Crime,29374178,Bless the Child,107,5.1,12659,-35625822
3225,2000000,Drama,1568749,Hamlet,112,6.0,8354,-431251
3226,0,Drama,25461,Werckmeister Harmonies,145,8.3,9773,25461
3227,0,Drama,95242,Code Unknown,118,7.2,9286,95242
3228,1000000,Drama,1523941,Girlfight,110,6.8,8530,523941
3229,10000000,Comedy,1631839,Gun Shy,101,5.7,6181,-8368161
3230,50000000,Drama,16779636,Lost Souls,97,4.8,9712,-33220364
3231,10000000,Comedy,1284646,Cecil B. DeMented,87,6.2,11917,-8715354
3232,0,Comedy,1069156,Together,106,7.5,18441,1069156
3233,1800000,Drama,3050934,Songcatcher,109,7.2,2939,1250934
3234,8000000,Comedy,5018450,Woman on Top,92,5.3,9009,-2981550
3235,0,Drama,30181,Dancing at the Blue Iguana,123,5.8,3317,30181
3236,10000000,Crime,447750,Brother,114,7.2,19600,-9552250
3237,63000000,Comedy,10014234,Lucky Numbers,105,5.0,8957,-52985766
3238,15000000,Comedy,4734235,Duets,112,6.0,8505,-10265765
3239,3600000,Crime,43805,Animal Factory,94,6.6,11086,-3556195
3240,1500000,Comedy,265107,Psycho Beach Party,95,6.3,4825,-1234893
3241,42000,Drama,241816,George Washington,89,7.4,6692,199816
3242,0,Comedy,6920692,State and Main,105,6.8,18881,6920692
3243,0,Biography,5708,Ed Gein,89,5.6,4568,5708
3244,0,Comedy,2303,Songs from the Second Floor,98,7.7,14022,2303
3245,150000,Comedy,2882062,Tadpole,78,6.2,5310,2732062
3246,12500000,Drama,5217498,The In Crowd,105,4.6,3803,-7282502
3247,1000000,Comedy,1744858,The Broken Hearts Club: A Romantic Comedy,94,7.0,6337,744858
3248,6000000,Crime,15427192,Drowning Mona,96,5.6,12165,9427192
3249,13000000,Romance,284291,Love's Labour's Lost,93,6.1,3984,-12715709
3250,24000000,Comedy,25167270,Nurse Betty,110,6.2,30785,1167270
3251,8000000,Drama,52526,The Million Dollar Hotel,122,5.9,19103,-7947474
3252,0,Crime,274675,Hey Ram,186,8.0,8729,274675
3253,30000000,Animation,45554533,The Tigger Movie,77,6.3,14258,15554533
3254,8500000,Drama,327418,Waking the Dead,105,6.7,6173,-8172582
3255,0,Comedy,1143,"Love, Honor and Obey",103,6.5,4542,1143
3256,0,Action,356000,Kaho Naa... Pyaar Hai,172,6.9,10926,356000
3257,0,Drama,449482,Lockdown,105,6.3,2134,449482
3258,10000000,Romance,3041803,The House of Mirth,135,7.1,6606,-6958197
3259,120000,Crime,14904,Vulgar,87,5.3,3665,-105096
3260,10000000,Comedy,7027345,Screwed,81,5.7,7286,-2972655
3261,16000000,Animation,17052128,Pokémon 3: The Movie,93,5.7,10090,1052128
3262,0,Comedy,1111273,Sordid Lives,111,6.8,2477,1111273
3263,50000000,Adventure,6543194,I Dreamed of Africa,114,5.6,3933,-43456806
3264,3000000,Comedy,40361,Committed,98,5.2,3330,-2959639
3265,51000000,Action,15325127,Bait,119,5.7,9493,-35674873
3266,15000000,Drama,10494147,Here on Earth,96,5.1,7660,-4505853
3267,0,Crime,45826,The Monkey's Mask,93,5.1,1346,45826
3268,4000000,Drama,945041,Timecode,97,6.2,6042,-3054959
3269,0,Drama,125651,O Fantasma,87,5.7,2379,125651
3270,250000,Comedy,1050600,Chuck & Buck,96,6.6,4800,800600
3271,1000000,Drama,21075,The Isle,90,7.1,10866,-978925
3272,0,Comedy,18223,Devils on the Doorstep,139,8.3,5388,18223
3273,25000000,Comedy,14990582,The Next Best Thing,108,4.7,9717,-10009418
3274,0,Drama,669258,The Claim,120,6.5,5448,669258
3275,0,Comedy,546287,Love & Sex,82,6.3,4781,546287
3276,36000000,Biography,49464,Vatel,103,6.6,6605,-35950536
3277,1000000,Action,12996,The Specials,82,6.0,2010,-987004
3278,0,Animation,116710,Greedy Guts,132,7.4,5091,116710
3279,0,Comedy,688510,Happy Accidents,110,7.3,8717,688510
3280,60000000,Comedy,6291602,What Planet Are You From?,105,5.6,8346,-53708398
3281,0,Animation,25521,Vampire Hunter D: Bloodlust,103,7.7,24614,25521
3282,0,Comedy,86132,Water Drops on Burning Rocks,82,6.9,5166,86132
3283,0,Drama,94940,Better Than Sex,95,6.4,2002,94940
3284,0,Drama,1450106,Under the Sand,92,7.2,7119,1450106
3285,0,Drama,8867,Come Undone,98,6.7,4360,8867
3286,0,Comedy,1439287,Greenfingers,91,6.9,4800,1439287
3287,0,Comedy,5311177,Bread and Tulips,114,7.4,8210,5311177
3288,1000000,Comedy,779137,Panic,88,6.8,7413,-220863
3289,0,Comedy,151559,About Adam,97,6.0,5918,151559
3290,0,Comedy,55381,Beautiful Creatures,86,5.9,3150,55381
3291,0,Action,729844,Taxi 2 - Alta tensión,88,6.4,43387,729844
3292,4500000,Comedy,1246237,MVP: Most Valuable Primate,93,3.8,1908,-3253763
3293,0,Comedy,4447186,Italiano para principiantes,112,7.1,11759,4447186
3294,0,Drama,16239,Restless,111,5.6,3367,16239
3295,0,Comedy,8351,Maybe Baby,104,5.7,5148,8351
3296,1000000,Action,623791,Fiza,170,6.1,3131,-376209
3297,28000000,Drama,5658940,El asalto,89,6.3,4730,-22341060
3298,5000000,Animation,9628751,Digimon: The Movie,100,6.0,5625,4628751
3299,0,Comedy,3926,Sunset Strip,90,5.7,1314,3926
3300,125000000,Adventure,317575550,Harry Potter and the Sorcerer's Stone,152,7.5,499582,192575550
3301,93000000,Adventure,315544750,The Lord of the Rings: The Fellowship of the Ring,178,8.8,1352483,222544750
3302,10000000,Horror,37904175,El demonio,90,6.1,94632,27904175
3303,15000000,Drama,7220243,Mulholland Drive,147,8.0,263699,-7779757
3304,4500000,Drama,194220,Donnie Darko,113,8.1,635416,-4305780
3305,19000000,Animation,10055859,Spirited Away,125,8.6,476278,-8944141
3306,115000000,Action,131144183,Lara Croft: Tomb Raider,100,5.8,167892,16144183
3307,58000000,Biography,170742341,A Beautiful Mind,135,8.2,681379,112742341
3308,115000000,Animation,289916256,"Monsters, Inc.",92,8.1,652440,174916256
3309,0,Comedy,33225499,Amélie,122,8.4,586883,33225499
3310,45000000,Crime,76631907,Training Day,122,7.7,328937,31631907
3311,18000000,Comedy,96520674,Legally Blonde,96,6.2,145161,78520674
3312,92000000,Drama,108638745,Black Hawk Down,144,7.7,313611,16638745
3313,38000000,Action,144533925,The Fast and the Furious,106,6.7,295769,106533925
3314,60000000,Animation,267665011,Shrek,90,7.9,506495,207665011
3315,87000000,Crime,165092268,Hannibal,131,6.8,221016,78092268
3316,53000000,Biography,52990775,Blow,124,7.6,210713,-9225
3317,5000000,Comedy,292102,Wet Hot American Summer,97,6.7,45495,-4707898
3318,100000000,Action,180011740,Planet of the Apes,119,5.7,189575,80011740
3319,1200000,Comedy,18488314,Super Troopers,100,7.1,80904,17288314
3320,85000000,Crime,183405771,Ocean's Eleven,116,7.8,434421,98405771
3321,140000000,Action,198542554,Pearl Harbor,183,6.1,272170,58542554
3322,17000000,Horror,96522687,Los otros,101,7.6,291033,79522687
3323,21000000,Comedy,52364010,The Royal Tenenbaums,110,7.6,225505,31364010
3324,50000000,Drama,57386607,Amor en rojo,127,7.6,236999,7386607
3325,57000000,Drama,17008282,Rock Star,105,6.2,36324,-39991718
3326,100000000,Adventure,78616689,A.I. Artificial Intelligence,146,7.1,255580,-21383311
3327,2000000,Adventure,13622333,Y Tu Mamá También,106,7.7,97627,11622333
3328,26000000,Comedy,108248956,The Princess Diaries,111,6.3,103820,82248956
3329,35000000,Action,112719001,Spy Kids,88,5.4,90839,77719001
3330,15000000,Comedy,38252284,Not Another Teen Movie,89,5.7,85003,23252284
3331,98000000,Action,202019785,The Mummy Returns,130,6.3,264562,104019785
3332,68000000,Fantasy,100614858,Vanilla Sky,136,6.9,218433,32614858
3333,65000000,Action,56569702,A Knight's Tale,132,6.9,146093,-8430298
3334,120000000,Animation,84052762,Atlantis: The Lost Empire,95,6.8,80961,-35947238
3335,45000000,Comedy,71308997,Scary Movie 2,83,5.3,127881,26308997
3336,0,Drama,1490177,Sex and Lucia,128,7.2,31120,1490177
3337,35000000,Horror,31602566,From Hell,122,6.8,131821,-3397434
3338,25000000,Comedy,71543427,Bridget Jones's Diary,97,6.7,188905,46543427
3339,42000000,Horror,41867960,Thir13en Ghosts,91,5.6,69143,-132040
3340,42000000,Drama,16252765,Original Sin,116,6.0,47417,-25747235
3341,30000000,Comedy,145103595,American Pie 2,108,6.4,211629,115103595
3342,68000000,Drama,51401758,Enemy at the Gates,131,7.6,205191,-16598242
3343,28000000,Comedy,45172250,Zoolander,90,6.6,215281,17172250
3344,22000000,Drama,40311852,I Am Sam,132,7.6,128721,18311852
3345,0,Drama,1900282,The Piano Teacher,131,7.4,43270,1900282
3346,28000000,Comedy,50294317,Serendipity,90,6.9,91590,22294317
3347,93000000,Action,181171875,Jurassic Park III,92,5.9,239644,88171875
3348,107000000,Biography,58203105,Ali,157,6.8,83314,-48796895
3349,4000000,Drama,31252964,Monster's Ball,111,7.1,74601,27252964
3350,22000000,Comedy,30059386,Jay and Silent Bob Strike Back,104,6.9,134314,8059386
3351,7000000,Comedy,6217849,Ghost World,111,7.4,101596,-782151
3352,48000000,Adventure,56618055,Rat Race,112,6.4,97606,8618055
3353,39000000,Comedy,14252830,Josie and the Pussycats,98,5.3,19643,-24747170
3354,68000000,Drama,50338485,K-PAX,120,7.4,158661,-17661515
3355,40000000,Comedy,70836296,Shallow Hal,114,5.9,114670,30836296
3356,68000000,Crime,71069884,The Score,124,6.8,107003,3069884
3357,20000000,Comedy,31155435,How High,93,6.3,45777,11155435
3358,11000000,Action,13121555,Jason X,91,4.4,41959,2121555
3359,102000000,Action,69772969,Swordfish,99,6.5,161863,-32227031
3360,35000000,Crime,19719930,The Pledge,124,6.8,45224,-15280070
3361,1500000,Horror,378176,Session 9,100,6.5,46688,-1121824
3362,0,Animation,2892011,Waking Life,99,7.8,52974,2892011
3363,90000000,Action,226164286,Rush Hour 2,90,6.6,171603,136164286
3364,11000000,Crime,13103828,Frailty,100,7.3,65717,2103828
3365,17700000,Adventure,27087695,Joe Dirt,91,5.9,44133,9387695
3366,0,Biography,1537670,Bully,108,7.0,30774,1537670
3367,57000000,Adventure,66808615,The Mexican,123,6.1,91818,9808615
3368,4500000,Drama,754749,The Devil's Backbone,106,7.5,51628,-3745251
3369,23000000,Mystery,21973182,Joy Ride,97,6.6,56355,-1026818
3370,60000000,Drama,74078174,Along Came a Spider,104,6.3,62868,14078174
3371,20000000,Crime,7494849,The Man Who Wasn't There,116,7.6,90712,-12505151
3372,13000000,Drama,91057006,Save the Last Dance,112,6.2,50689,78057006
3373,40000000,Action,59068786,Behind Enemy Lines,106,6.4,90731,19068786
3374,19800000,Comedy,41308615,Gosford Park,131,7.3,68601,21508615
3375,13000000,Adventure,5002310,Bubble Boy,84,5.6,27008,-7997690
3376,80000000,Comedy,38345494,Evolution,101,6.1,106732,-41654506
3377,0,Action,11260096,Brotherhood of the Wolf,142,7.1,55046,11260096
3378,115000000,Action,26871,Juego de espías,126,7.1,127397,-114973129
3379,16000000,Crime,28734552,Baby Boy,130,6.4,10533,12734552
3380,48000000,Comedy,47121859,Kate & Leopold,118,6.4,69008,-878141
3381,35000000,Comedy,40334024,Heartbreakers,123,6.2,46273,5334024
3382,28000000,Action,8434601,Ghosts of Mars,98,4.9,45304,-19565399
3383,50000000,Drama,55001642,Don't Say a Word,113,6.3,42609,5001642
3384,70000000,Animation,13596911,Osmosis Jones,95,6.3,27295,-56403089
3385,21150000,Adventure,25635682,Cocodrilo Dundee en Hollywood,92,4.8,20819,4485682
3386,1500000,Drama,406035,The Believer,98,7.2,32324,-1093965
3387,40000000,Drama,25288103,Sweet November,119,6.7,74702,-14711897
3388,75000000,Comedy,41575141,Bandits,123,6.5,59465,-33424859
3389,72000000,Action,18208078,The Last Castle,131,6.9,60328,-53791922
3390,10000000,Horror,20384136,Valentine,96,4.7,21498,10384136
3391,35000000,Comedy,60400856,The Wedding Planner,103,5.2,65818,25400856
3392,6000000,Adventure,70147,Lagaan: Once Upon a Time in India,224,8.2,82703,-5929853
3393,10000000,Action,488872,Shaolin Soccer,113,7.3,62092,-9511128
3394,0,Drama,141072,The Experiment,114,7.8,82797,141072
3395,60000000,Action,24403552,15 Minutes,120,6.1,44327,-35596448
3396,31000000,Drama,24185781,Hearts in Atlantis,101,6.9,32102,-6814219
3397,7000000,Comedy,3293258,Pootie Tang,81,5.2,11971,-3706742
3398,0,Drama,103440,Intimidad,119,6.2,9815,103440
3399,72000000,Drama,27807266,The Majestic,152,6.9,47073,-44192734
3400,27000000,Drama,15652637,Life as a House,125,7.5,40296,-11347363
3401,25000000,Action,36845124,Kiss of the Dragon,98,6.6,55439,11845124
3402,23000000,Comedy,27338033,Someone Like You...,97,6.1,21020,4338033
3403,46000000,Comedy,93607673,America's Sweethearts,102,5.7,49618,47607673
3404,48000000,Biography,30165536,Riding in Cars with Boys,132,6.5,23914,-17834464
3405,30000000,Animation,80936232,Jimmy Neutron: Boy Genius,82,6.0,25867,50936232
3406,39000000,Action,47239,Heist,109,6.5,29165,-38952761
3407,24000000,Comedy,13903262,Out Cold,89,6.3,15136,-10096738
3408,60000000,Action,93385515,Cats & Dogs,87,5.1,48987,33385515
3409,30000000,Crime,18001232,The Glass House,106,5.8,27097,-11998768
3410,49000000,Action,43905746,The One,87,5.9,81803,-5094254
3411,5000000,Drama,16017403,O,95,6.2,17805,11017403
3412,0,Drama,302365,Lost and Delirious,103,7.0,17910,302365
3413,22000000,Comedy,11560259,Get Over It,87,5.8,16224,-10439741
3414,137000000,Animation,32131830,Final Fantasy: The Spirits Within,106,6.4,75443,-104868170
3415,22000000,Action,19351569,Saving Silverman,90,5.9,34712,-2648431
3416,0,Comedy,114183,Secret Ballot,100,6.7,1107,114183
3417,1700000,Crime,35930604,In the Bedroom,130,7.5,33720,34230604
3418,28000000,Action,5204007,Formula 51,93,6.3,44231,-22795993
3419,0,Drama,4298329,Enigma,119,6.4,18387,4298329
3420,34000000,Comedy,19693891,Summer Catch,108,5.0,13643,-14306109
3421,0,Comedy,4013506,The Anniversary Party,115,6.3,7603,4013506
3422,0,Animation,1000045,Cowboy Bebop: The Movie,115,7.9,35003,1000045
3423,14000000,Comedy,14249005,Freddy Got Fingered,87,4.5,41235,249005
3424,0,Comedy,92770,Mean Machine,99,6.5,31212,92770
3425,11000000,Comedy,13276953,Sugar & Spice,81,5.6,12035,2276953
3426,75000000,Animation,5411999,Monkeybone,93,4.7,15048,-69588001
3427,32000000,Drama,40219708,Hardball,106,6.4,23931,8219708
3428,18000000,Comedy,13729742,The Tailor of Panama,109,6.1,25012,-4270258
3429,75000000,Crime,45207112,Domestic Disturbance,89,5.5,22199,-29792888
3430,94000000,Action,32616869,Driven,116,4.5,35770,-61383131
3431,57000000,Drama,25543895,Captain Corelli's Mandolin,131,5.9,29405,-31456105
3432,6000000,Comedy,3029081,Hedwig and the Angry Inch,95,7.8,27739,-2970919
3433,15000000,Comedy,353743,Buffalo Soldiers,98,6.9,21383,-14646257
3434,47000000,Comedy,57743062,The Animal,84,4.8,50142,10743062
3435,14000000,Comedy,10397365,Head Over Heels,86,5.4,12325,-3602635
3436,50000000,Adventure,33422806,Black Knight,95,4.8,32829,-16577194
3437,0,Drama,1096037,The Center of the World,88,5.9,4177,1096037
3438,0,Crime,11632420,Knockaround Guys,92,6.1,20533,11632420
3439,0,Drama,1059830,Tierra de nadie,98,8.0,39646,1059830
3440,13000000,Drama,16929123,Crazy/Beautiful,99,6.5,22201,3929123
3441,62000000,Action,15738632,3000 Miles to Graceland,125,5.9,39439,-46261368
3442,5500000,Biography,1292119,Iris,91,7.1,15426,-4207881
3443,50000000,Action,51758599,Exit Wounds,101,5.5,28779,1758599
3444,18000000,Comedy,6290673,One Night at McCool's,93,6.1,26528,-11709327
3445,35000000,Drama,11434216,The Shipping News,111,6.8,29749,-23565784
3446,0,Horror,49046,Pulse,118,6.6,12875,49046
3447,30000000,Action,10965209,Antitrust,105,6.1,26399,-19034791
3448,53000000,Drama,24044532,Angel Eyes,102,5.6,20298,-28955468
3449,0,Comedy,1080072,Crush,108,5.9,3351,1080072
3450,25000000,Comedy,17292381,Max Keeble's Big Move,86,5.4,6177,-7707619
3451,49000000,Comedy,64186502,Estrenando Cuerpo,87,5.4,19724,15186502
3452,700000,Crime,1141829,L.I.E.,97,7.2,8842,441829
3453,0,Drama,2902000,Kabhi Khushi Kabhie Gham...,210,7.5,34762,2902000
3454,90000000,Comedy,6719973,Town & Country,104,4.4,4284,-83280027
3455,35000000,Action,13264986,American Outlaws,94,6.0,12534,-21735014
3456,40000000,Drama,6114237,Impostor,95,6.2,20767,-33885763
3457,0,Comedy,695876,Human Nature,96,6.4,16067,695876
3458,60000000,Comedy,32095318,What's the Worst That Could Happen?,94,5.5,13245,-27904682
3459,38000000,Action,623374,Texas Rangers,90,5.2,4922,-37376626
3460,11000000,Comedy,13558739,Tomcats,95,5.3,15912,2558739
3461,13000000,Comedy,4919896,Birthday Girl,93,6.1,22359,-8080104
3462,0,Comedy,13876974,Monsoon Wedding,114,7.4,20856,13876974
3463,0,Horror,9189,Sangre caníbal,101,6.0,5701,9189
3464,33000000,Comedy,7496522,The Curse of the Jade Scorpion,103,6.8,33870,-25503478
3465,1000000,Comedy,7022940,Kissing Jessica Stein,97,6.6,14583,6022940
3466,70000000,Comedy,112952899,Dr. Dolittle 2,87,4.7,36199,42952899
3467,100000,Drama,490475,Tape,86,7.3,16687,390475
3468,5000000,Comedy,5308707,Made,95,6.4,15620,308707
3469,35000000,Comedy,4777007,Just Visiting,88,5.8,16103,-30222993
3470,22000000,Drama,4273372,Glitter,104,2.2,20019,-17726628
3471,0,Animation,37285,Millennium Actress,87,7.9,16917,37285
3472,0,Drama,724116,Fat Girl,100,6.5,8715,724116
3473,40000000,Action,27053815,El mosquetero,104,4.7,13209,-12946185
3474,250000,Comedy,4186931,Lovely & Amazing,91,6.9,6267,3936931
3475,4500000,Drama,3288164,Thirteen Conversations About One Thing,104,7.1,8888,-1211836
3476,5000000,Drama,517872,The Grey Zone,108,7.1,9158,-4482128
3477,7000000,Adventure,4720371,The Other Side of Heaven,113,6.5,3408,-2279629
3478,25000000,Comedy,5516708,Say It Isn't So,95,4.9,11736,-19483292
3479,0,Drama,850023,An American Rhapsody,106,6.9,3417,850023
3480,16000000,Crime,7307756,Bones,96,4.1,5852,-8692244
3481,0,Comedy,912442,Storytelling,87,6.9,15833,912442
3482,35000000,Action,33357476,See Spot Run,94,5.4,7788,-1642524
3483,6000000,Comedy,27457409,The Brothers,106,6.4,3480,21457409
3484,0,Comedy,300000,Dil Chahta Hai,183,8.2,54875,300000
3485,7000000,Comedy,10097096,The Wash,100,4.7,5897,3097096
3486,3000000,Crime,8821782,The Deep End,101,6.7,10111,5821782
3487,20000000,Drama,668140,Charlotte Gray,121,6.4,9455,-19331860
3488,0,Comedy,624153,Son of the Bride,123,7.9,12533,624153
3489,15000000,Horror,7288451,The Forsaken,90,5.3,7560,-7711549
3490,0,Comedy,103215,La Ciénaga,103,7.0,3777,103215
3491,0,Drama,304909,Me Without You,94,7.0,3970,304909
3492,11000000,Comedy,23978402,Corky Romano,86,4.6,11303,12978402
3493,0,Drama,69716,Manic,100,7.4,8676,69716
3494,30000000,Drama,430313,The Affair of the Necklace,100,6.1,4644,-29569687
3495,23000000,Animation,36696761,Recess: School's Out,82,6.6,7522,13696761
3496,12000000,Biography,419414,Bride of the Wind,100,5.7,536,-11580586
3497,38000000,Comedy,22770864,Joe Somebody,98,5.5,8891,-15229136
3498,0,Crime,1359133,Read My Lips,115,7.4,11746,1359133
3499,7000000,Drama,3209481,The Cat's Meow,114,6.4,7093,-3790519
3500,17000000,Drama,3100650,Soul Survivors,84,3.9,7504,-13899350
3501,7000000,Drama,411034,CQ,88,6.3,4247,-6588966
3502,0,Drama,4460426,Parejas en conflicto,121,7.3,17112,4460426
3503,0,Drama,13031,Dog Days,121,7.1,5262,13031
3504,0,Comedy,637769,Blow Dry,94,6.3,7177,637769
3505,0,Comedy,4447014,Tortilla Soup,102,6.6,3663,4447014
3506,0,Drama,80636,Invincible,133,6.5,3695,80636
3507,0,Action,702777,Ashoka the Great,169,6.7,11597,702777
3508,13000000,Comedy,22235901,Two Can Play That Game,90,6.1,4642,9235901
3509,0,Comedy,4160475,Mostly Martha,109,7.3,7121,4160475
3510,0,Action,81525,Wasabi,94,6.6,31525,81525
3511,7000000,Comedy,23247539,Kingdom Come,94,5.7,1846,16247539
3512,0,Drama,1014416,The Son's Room,99,7.4,15598,1014416
3513,13500000,Crime,687194,The Caveman's Valentine,105,6.0,5794,-12812806
3514,0,Drama,302675,Intacto,108,6.9,11784,302675
3515,10000000,Comedy,4356743,On the Line,85,4.1,3767,-5643257
3516,2500000,Comedy,405182,Little Secrets,96,6.5,2814,-2094818
3517,0,Drama,3786801,Atanarjuat: The Fast Runner,172,7.5,5768,3786801
3518,0,Drama,319125,The Safety of Objects,121,6.6,3853,319125
3519,0,Biography,6173485,En algún lugar de África,141,7.7,11175,6173485
3520,100000000,Crime,77812000,Gangs of New York,167,7.5,340246,-22188000
3521,100000000,Adventure,261988482,Harry Potter and the Chamber of Secrets,161,7.4,432417,161988482
3522,139000000,Action,403706375,Spider-Man,121,7.3,587005,264706375
3523,52000000,Biography,164615351,Catch Me If You Can,141,8.1,611179,112615351
3524,3300000,Crime,7563397,City of God,130,8.7,580295,4263397
3525,35000000,Biography,32572577,The Pianist,150,8.5,558449,-2427423
3526,11000000,Drama,41227069,A Walk to Remember,101,7.4,174670,30227069
3527,0,Crime,753501,Irreversible,97,7.4,95140,753501
3528,45000000,Comedy,170687518,Chicago,113,7.2,184943,125687518
3529,8000000,Drama,45064915,28 Days Later...,113,7.6,320108,37064915
3530,94000000,Adventure,342551365,The Lord of the Rings: The Two Towers,179,8.7,1206786,248551365
3531,48000000,Horror,129128133,The Ring,115,7.1,275425,81128133
3532,41000000,Drama,116724075,8 Mile,110,7.0,204990,75724075
3533,84000000,Animation,153288182,Scooby-Doo,100,5.0,77811,69288182
3534,50000000,Drama,52801000,Unfaithful,124,6.7,67756,2801000
3535,102000000,Action,132072926,Minority Report,145,7.7,430579,30072926
3536,4000000,Comedy,4059680,Secretary,107,7.0,72138,59680
3537,60000000,Action,121661683,The Bourne Identity,119,7.9,442597,61661683
3538,35000000,Action,54234062,The Count of Monte Cristo,131,7.7,111649,19234062
3539,80000000,Crime,104454762,Road to Perdition,117,7.7,214021,24454762
3540,38000000,Comedy,127223418,Sweet Home Alabama,108,6.2,89028,89223418
3541,115000000,Action,310675583,Star Wars: Episode II - Attack of the Clones,142,6.6,510731,195675583
3542,75000000,Action,78122718,We Were Soldiers,138,7.2,111599,3122718
3543,48000000,Crime,96397334,Panic Room,112,6.8,220623,48397334
3544,46000000,Drama,67355513,Insomnia,118,7.2,235773,21355513
3545,25000000,Drama,41675994,The Hours,110,7.6,108353,16675994
3546,78000000,Crime,93149898,Dragón rojo,124,7.2,215791,15149898
3547,33000000,Action,40119709,Resident Evil,100,6.7,216222,7119709
3548,20000000,Action,1203974,Equilibrium,107,7.5,277569,-18796026
3549,142000000,Action,160942139,Die Another Day,133,6.1,179342,18942139
3550,140000000,Action,190418803,Men in Black II,88,6.1,284356,50418803
3551,72000000,Drama,227966634,Signs,106,6.7,292420,155966634
3552,19000000,Comedy,22245861,Adaptation.,114,7.7,153539,3245861
3553,54000000,Action,82348319,Blade II,117,6.7,171317,28348319
3554,5000000,Comedy,241438208,Casarse... está en griego,95,6.6,107984,236438208
3555,60000000,Action,43254409,Star Trek: Nemesis,116,6.4,62507,-16745591
3556,59000000,Animation,176387405,Ice Age,81,7.6,357258,117387405
3557,70000000,Action,142109382,xXx,124,5.8,156008,72109382
3558,0,Comedy,35081594,The Hot Chick,104,5.5,79439,35081594
3559,80000000,Animation,145794338,Lilo & Stitch,85,7.2,131270,65794338
3560,63000000,Action,213307889,Austin Powers in Goldmember,94,6.2,172153,150307889
3561,0,Comedy,32543449,Bend It Like Beckham,112,6.7,94400,32543449
3562,13000000,Crime,46566212,Phone Booth,81,7.1,221926,33566212
3563,12000000,Biography,25885000,Frida,123,7.4,66915,13885000
3564,18000000,Comedy,41032915,Orange County,82,6.2,42919,23032915
3565,140000000,Animation,38176783,Treasure Planet,95,7.1,79637,-101823217
3566,100000000,Drama,35168966,K-19: The Widowmaker,138,6.7,52002,-64831034
3567,6000000,Comedy,21005329,Van Wilder: Party Liaison,92,6.4,93275,15005329
3568,60000000,Action,43061982,Reign of Fire,101,6.2,113304,-16938018
3569,60000000,Action,91047077,The Scorpion King,92,5.5,110841,31047077
3570,25000000,Comedy,17844216,Punch-Drunk Love,95,7.3,118802,-7155784
3571,35000000,Horror,30113491,Ghost Ship,91,5.5,80523,-4886509
3572,43000000,Comedy,24718164,The Sweetest Thing,88,5.1,48712,-18281836
3573,47000000,Drama,14970038,Solaris,99,6.2,70859,-32029962
3574,21000000,Action,25296447,The Transporter,92,6.8,252974,4296447
3575,30000000,Comedy,41385278,About a Boy,101,7.1,151125,11385278
3576,40000000,Comedy,14448589,Life or Something Like It,103,5.8,20540,-25551411
3577,31000000,Action,53710019,Hero,107,7.9,157335,22710019
3578,6428966,Crime,169659,Infernal Affairs,101,8.1,100326,-6259307
3579,35000000,Drama,30336800,Queen of the Damned,101,5.3,46391,-4663200
3580,32000000,Drama,35746370,The Mothman Prophecies,119,6.5,67002,3746370
3581,60000000,Comedy,93354851,Two Weeks Notice,101,6.1,91854,33354851
3582,38000000,Crime,40007742,Enough,115,5.7,32959,2007742
3583,8000000,Drama,14015786,The Good Girl,93,6.5,39603,6015786
3584,5000000,Drama,13060843,25th Hour,135,7.7,156154,8060843
3585,1500000,Comedy,21158188,Cabin Fever,93,5.6,65465,19658188
3586,80000000,Animation,73280117,Spirit: Stallion of the Cimarron,83,7.1,50166,-6719883
3587,80000000,Action,56684819,The Time Machine,96,5.9,108052,-23315181
3588,15000000,Comedy,30354442,Halloween: Resurrection,94,4.1,29063,15354442
3589,30000000,Drama,40390647,Blue Crush,104,5.6,27193,10390647
3590,115000000,Action,40914068,Windtalkers,134,6.0,58906,-74085932
3591,85000000,Action,40077257,Collateral Damage,108,5.5,64737,-44922743
3592,50000000,Comedy,126293452,Mr. Deeds,96,5.8,118036,76293452
3593,68000000,Action,118907036,The Sum of All Fears,124,6.4,91007,50907036
3594,55000000,Comedy,94011225,Maid in Manhattan,105,5.1,72953,39011225
3595,36000000,Crime,71756802,John Q,116,7.1,106341,35756802
3596,4000000,Comedy,6532619,The Rules of Attraction,110,6.7,45923,2532619
3597,0,Drama,9284265,Talk to Her,112,8.0,91586,9284265
3598,70000000,Action,30160161,Bad Company,116,5.6,41284,-39839839
3599,42000000,Crime,41543207,High Crimes,115,6.3,32605,-456793
3600,0,Adventure,3115188,Asterix and Obelix Meet Cleopatra,107,6.6,40503,3115188
3601,15000000,Drama,19158074,Tuck Everlasting,90,6.7,18985,4158074
3602,38000000,Action,85846429,Spy Kids 2: Island of Lost Dreams,100,5.1,49101,47846429
3603,21000000,Drama,6835856,Moonlight Mile,112,6.7,12451,-14164144
3604,8000000,Drama,1641788,Spider,98,6.8,31663,-6358212
3605,29000000,Biography,16003576,Confessions of a Dangerous Mind,113,7.1,74700,-12996424
3606,30000000,Comedy,65016287,About Schmidt,125,7.2,112029,35016287
3607,50000000,Crime,31874869,Murder by Numbers,115,6.1,46166,-18125131
3608,13500000,Drama,15854988,Far from Heaven,107,7.4,38469,2354988
3609,34000000,Animation,23443124,Eight Crazy Nights,76,5.3,19027,-10556876
3610,10000000,Comedy,32983713,Friday After Next,85,5.8,21274,22983713
3611,12000000,Comedy,37191304,Crossroads,93,3.4,35300,25191304
3612,12000000,Drama,31597131,One Hour Photo,96,6.8,102344,19597131
3613,30000000,Action,17322606,Eight Legged Freaks,99,5.4,46341,-12677394
3614,17000000,Comedy,37950822,40 Days and 40 Nights,96,5.6,64465,20950822
3615,4000000,Crime,45289,Sympathy for Mr. Vengeance,129,7.7,50651,-3954711
3616,15000000,Adventure,47811275,Big Fat Liar,88,5.4,30579,32811275
3617,10000000,Drama,1587173,Nicholas Nickleby,132,7.2,9963,-8412827
3618,60000000,Action,50547998,The Tuxedo,98,5.3,67127,-9452002
3619,0,Comedy,9680913,S1m0ne,117,6.1,54019,9680913
3620,30000000,Action,62536,Trapped,106,6.2,20617,-29937464
3621,13000000,Comedy,28972187,The New Guy,88,5.9,29982,15972187
3622,500000,Drama,150277,May,93,6.7,28449,-349723
3623,2000000,Comedy,410241,Spun,101,6.8,33439,-1589759
3624,20000000,Drama,75600072,The Rookie,127,7.0,28077,55600072
3625,10000000,Comedy,7876,Swept Away,89,3.6,13734,-9992124
3626,20000000,Comedy,8586376,Boat Trip,94,4.9,27849,-11413624
3627,20000000,Action,12398628,Undisputed,100,6.2,24459,-7601372
3628,10000000,Action,16033556,Kung Pow: Enter the Fist,81,6.2,39559,6033556
3629,16000000,Drama,16346122,White Oleander,109,7.2,26787,346122
3630,35000000,Crime,6592103,Mujer fatal,114,6.3,29963,-28407897
3631,15000000,Action,9059588,Dark Blue,118,6.6,18124,-5940412
3632,65000000,Comedy,139236327,The Santa Clause 2,104,5.6,38234,74236327
3633,45000000,Drama,66818548,Changing Lanes,98,6.5,60451,21818548
3634,0,Action,3042188,Paid in Full,97,7.1,8112,3042188
3635,40000000,Horror,605562,Below,105,6.2,18804,-39394438
3636,26000000,Action,36985501,Clockstoppers,94,5.2,11909,10985501
3637,40000000,Comedy,7262288,Big Trouble,85,6.5,18116,-32737712
3638,16000000,Comedy,4839383,Hollywood Ending,112,6.6,23072,-11160617
3639,35000000,Adventure,81172560,Snow Dogs,99,5.1,21710,46172560
3640,8500000,Drama,28563926,Swimfan,85,5.0,17091,20063926
3641,20000000,Comedy,56398162,Drumline,118,5.7,29636,36398162
3642,0,Drama,20779666,La leyenda de las ballenas,101,7.6,35767,20779666
3643,50000000,Action,26199517,Blood Work,110,6.4,36540,-23800483
3644,35000000,Adventure,18306166,The Four Feathers,132,6.5,29532,-16693834
3645,12000000,Comedy,75782105,Barbershop,102,6.3,23871,63782105
3646,30000000,Comedy,51432423,Like Mike,99,5.1,16153,21432423
3647,0,Comedy,104533,Secret Things,115,6.1,3916,104533
3648,0,Biography,1130379,24 Hour Party People,117,7.4,28543,1130379
3649,85000000,Action,38082712,Showtime,95,5.5,54818,-46917288
3650,70000000,Action,33105600,I Spy,97,5.4,43883,-36894400
3651,18000000,Crime,764554,The Salton Sea,103,7.2,27543,-17235446
3652,16000000,Adventure,40363530,The Master of Disguise,80,3.3,19029,24363530
3653,15000000,Comedy,8378141,The Importance of Being Earnest,97,6.9,19899,-6621859
3654,70000000,Drama,19076815,Hart's War,125,6.3,45910,-50923185
3655,1000000,Comedy,2003420,Bubba Ho-Tep,92,7.2,40698,1003420
3656,3500000,Horror,325661,Ju-on: The Grudge,92,6.7,34319,-3174339
3657,25000000,Action,38230435,Undercover Brother,86,5.8,30636,13230435
3658,0,Crime,181655,Lilya 4-Ever,109,7.9,37477,181655
3659,10000000,Crime,8111360,Dirty Pretty Things,97,7.4,36601,-1888640
3660,27000000,Drama,69599016,Divine Secrets of the Ya-Ya Sisterhood,116,6.0,16109,42599016
3661,100000000,Comedy,4420080,The Adventures of Pluto Nash,95,3.8,21240,-95579920
3662,12500000,Biography,21078145,Antwone Fisher,120,7.3,28371,8578145
3663,120000000,Animation,64956806,Stuart Little 2,77,5.4,40457,-55043194
3664,7500000,Crime,10460089,Narc,105,7.2,35355,2960089
3665,0,Drama,15539266,Tierra de sueños,105,7.8,37725,15539266
3666,70000000,Action,18990798,Rollerball,98,3.0,23008,-51009202
3667,0,Comedy,267109,Waking Up in Reno,91,5.5,5105,267109
3668,60000000,Drama,30063805,Dragonfly,104,6.1,33117,-29936195
3669,55000000,Comedy,8355815,Death to Smoochy,109,6.4,35823,-46644185
3670,0,Crime,256620,The Reckoning,112,6.6,5191,256620
3671,0,Biography,144008,Dahmer,101,5.6,7967,144008
3672,29000000,Comedy,16930185,Serving Sara,100,5.3,15017,-12069815
3673,12000000,Comedy,10198766,Sorority Boys,93,5.4,12478,-1801234
3674,10600000,Horror,22163442,Darkness,88,5.4,17383,11563442
3675,0,Comedy,3895664,L'auberge espagnole,122,7.3,35944,3895664
3676,30000000,Drama,12987647,The Quiet American,101,7.1,24812,-17012353
3677,0,Drama,37439,Russian Ark,99,7.4,15616,37439
3678,17000000,Horror,12840842,They,89,4.8,11322,-4159158
3679,0,Crime,17639,Sonny,110,5.7,3628,17639
3680,6000000,Adventure,6165429,Cerca de la libertad,94,7.5,24515,165429
3681,4000000,Comedy,562059,Poolhall Junkies,99,7.0,8858,-3437941
3682,1200000,Biography,6073,Bundy,99,5.9,6232,-1193927
3683,20000000,Animation,48430258,Peter Pan II: Return to Neverland,72,5.8,14642,28430258
3684,25000000,Drama,10727683,Abandon,99,4.9,8168,-14272317
3685,3000000,Comedy,5844929,Real Women Have Curves,90,7.0,6236,2844929
3686,0,Drama,3663356,Laurel Canyon,103,6.4,13565,3663356
3687,42000000,Crime,13208023,Feardotcom,101,3.3,17833,-28791977
3688,35000000,Comedy,16988996,The Country Bears,88,4.0,4149,-18011004
3689,10000000,Drama,1483975,Evelyn,94,7.0,5611,-8516025
3690,11000000,Comedy,4814244,Slackers,86,5.3,12825,-6185756
3691,70000000,Action,14294842,Ballistic: Ecks vs. Sever,91,3.6,17279,-55705158
3692,60000000,Comedy,32122249,Analyze That,96,5.9,73442,-27877751
3693,3500000,Adventure,236266,Gerry,103,6.2,15933,-3263734
3694,0,Drama,4890878,The Magdalene Sisters,114,7.8,23296,4890878
3695,0,Musical,3500000,Devdas,185,7.6,29976,3500000
3696,7000000,Biography,2062066,Auto Focus,105,6.6,11759,-4937934
3697,0,Comedy,3076425,8 Women,111,7.1,25020,3076425
3698,0,Drama,28658,New Best Friend,91,5.3,2982,28658
3699,0,Drama,768045,Bloody Sunday,107,7.7,20817,768045
3700,12500000,Drama,14060950,The Emperor's Club,109,6.9,15086,1560950
3701,25000000,Drama,10103647,Possession,102,6.4,11970,-14896353
3702,10000000,Action,6044618,Deuces Wild,96,5.6,6400,-3955382
3703,9000000,Comedy,4681503,Igby Goes Down,98,7.0,29911,-4318497
3704,11000000,Crime,774317,Heaven,97,7.1,21282,-10225683
3705,60000000,Crime,22433915,City by the Sea,108,6.1,22160,-37566085
3706,55000000,Crime,79161,Eye See You,96,5.3,20748,-54920839
3707,0,Crime,31538,Sweet Sixteen,106,7.5,11376,31538
3708,60000000,Mystery,5350371,The Truth About Charlie,104,4.8,8899,-54649629
3709,9000000,Drama,121756,All or Nothing,128,7.6,8613,-8878244
3710,2000000,Comedy,2506446,Full Frontal,101,4.8,8888,506446
3711,13000000,Action,15361537,Half Past Dead,98,4.6,12824,2361537
3712,0,Comedy,921547,The Man Without a Past,97,7.7,18741,921547
3713,8000000,Romance,27362712,Brown Sugar,109,6.5,6451,19362712
3714,14000000,Action,25482931,All About the Benjamins,95,5.8,10283,11482931
3715,10000000,Comedy,30307416,The Banger Sisters,100,5.6,13034,20307416
3716,0,Comedy,3684305,Pinocchio,108,4.2,6772,3684305
3717,0,Drama,122308,Open Hearts,113,7.6,8429,122308
3718,0,Comedy,305690,Pumpkin,113,6.3,7792,305690
3719,1800000,Drama,5709616,El crimen del padre Amaro,100,6.8,11545,3909616
3720,0,Crime,2377348,Sendero de sangre,132,7.0,5859,2377348
3721,11000000,Comedy,3034181,The Guru,94,5.4,13953,-7965819
3722,500000,Drama,13134,The Slaughter Rule,112,6.1,2098,-486866
3723,17500000,Crime,43061,City of Ghosts,116,6.0,4529,-17456939
3724,0,Comedy,1266828,Roger Dodger,106,7.0,15809,1266828
3725,0,Romance,1009827,He Loves Me... He Loves Me Not,92,7.2,16938,1009827
3726,4000000,Comedy,146402,Mondays in the Sun,113,7.7,10762,-3853598
3727,0,Drama,267194,Morvern Callar,97,6.8,7294,267194
3728,11000000,Animation,11411644,The Powerpuff Girls Movie,73,6.5,8247,411644
3729,0,Drama,103874,XX/XY,91,6.0,2877,103874
3730,25000000,Animation,40108697,The Wild Thornberrys Movie,85,5.3,12741,15108697
3731,12000000,Comedy,333976,Welcome to Collinwood,86,6.4,12971,-11666024
3732,0,Drama,2099719,State Property,88,4.4,1705,2099719
3733,15600000,Comedy,13571817,Juwanna Mann,91,4.5,5482,-2028183
3734,3500000,Crime,17504595,Empire,90,6.0,6725,14004595
3735,0,Drama,503714,The Eye,99,6.7,25764,503714
3736,250000,Crime,3802390,Better Luck Tomorrow,101,7.2,8218,3552390
3737,3000000,Animation,13684949,Hey Arnold! The Movie,76,5.9,5065,10684949
3738,11000000,Drama,527019,Max,106,6.6,6491,-10472981
3739,0,Action,76584,So Close,100,6.7,6623,76584
3740,6000000,Drama,1800,The Room,99,3.6,40355,-5998200
3741,140000000,Action,305413918,Pirates of the Caribbean: The Curse of the Black Pearl,143,8.0,886092,165413918
3742,30000000,Action,70099045,Kill Bill: Vol. 1,111,8.1,807087,40099045
3743,94000000,Adventure,377845905,The Lord of the Rings: The Return of the King,201,8.9,1332020,283845905
3744,40000000,Comedy,59696144,Love Actually,135,7.7,346409,19696144
3745,3000000,Action,707481,Oldboy: Cinco días para vengarse,120,8.4,400279,-2292519
3746,17000000,Horror,35667218,Jeepers Creepers II,100,5.6,49100,18667218
3747,25000000,Crime,90135191,Mystic River,138,8.0,361466,65135191
3748,0,Drama,2531462,The Dreamers,115,7.2,89658,2531462
3749,137000000,Action,132177234,Hulk,138,5.7,223943,-4822766
3750,94000000,Animation,380843261,Finding Nemo,100,8.1,772029,286843261
3751,4000000,Drama,44585453,Lost in Translation,102,7.8,345221,40585453
3752,9200000,Horror,80571655,The Texas Chainsaw Massacre,98,6.2,114916,71371655
3753,1500000,Drama,4599680,Thirteen,100,6.8,72230,3099680
3754,4500000,Biography,34469210,Monster: Asesina en serie,109,7.3,114157,29969210
3755,12600000,Horror,15417771,Wrong Turn,84,6.1,93636,2817771
3756,40000000,Comedy,138614544,Cheaper by the Dozen,98,5.8,80652,98614544
3757,150000000,Action,281492479,The Matrix Reloaded,138,7.2,446954,131492479
3758,20000000,Adventure,67406573,Holes,117,7.1,63052,47406573
3759,22000000,Action,51970690,Underworld,121,7.0,225226,29970690
3760,70000000,Adventure,66257002,Big Fish,125,8.0,369336,-3742998
3761,78000000,Action,431881,Daredevil,103,5.3,185444,-77568119
3762,140000000,Action,111110575,The Last Samurai,154,7.7,340268,-28889425
3763,35000000,Comedy,81261177,School of Rock,108,7.1,224330,46261177
3764,200000000,Action,150371112,Terminator 3: Rise of the Machines,109,6.3,326064,-49628888
3765,60000000,Action,106128601,The Italian Job,111,7.0,302646,46128601
3766,30000000,Mystery,52159536,Identity,90,7.3,192146,22159536
3767,30000000,Action,82622655,Freddy vs. Jason,97,5.8,95076,52622655
3768,24000000,Comedy,75585093,Old School,88,7.2,193885,51585093
3769,76000000,Action,127154901,2 Fast 2 Furious,107,5.9,211309,51154901
3770,150000000,Action,139313948,Matrix Revolutions,129,6.7,387387,-10686052
3771,0,Crime,1530386,Dogville,178,8.0,115599,1530386
3772,78000000,Action,66465204,The League of Extraordinary Gentlemen,110,5.8,148712,-11534796
3773,100000000,Adventure,48462608,Peter Pan,113,6.9,57420,-51537392
3774,7000000,Horror,12634962,House of 1000 Corpses,89,6.0,64612,5634962
3775,68000000,Drama,33715436,Dreamcatcher,136,5.5,80087,-34284564
3776,95000000,Action,65660196,Lara Croft Tomb Raider: The Cradle of Life,117,5.5,110166,-29339804
3777,79000000,Adventure,95636509,Cold Mountain,154,7.2,124413,16636509
3778,81000000,Comedy,242829261,Bruce Almighty,101,6.7,319425,161829261
3779,110000000,Action,214949694,X-Men 2,134,7.5,441189,104949694
3780,150000000,Action,93927920,Master and Commander: The Far Side of the World,138,7.4,178098,-56072080
3781,22000000,Drama,58331254,Open Range,139,7.5,57419,36331254
3782,85000000,Action,47726342,The Rundown,104,6.7,87321,-37273658
3783,33000000,Comedy,173398518,Elf,97,6.9,162013,140398518
3784,50000000,Comedy,105813373,How to Lose a Guy in 10 Days,116,6.4,172078,55813373
3785,109000000,Adventure,101149285,The Cat in the Hat,82,3.8,39497,-7850715
3786,26000000,Comedy,110230332,Freaky Friday,97,6.1,104892,84230332
3787,120000000,Action,100830111,Charlie's Angels: Full Throttle,106,4.8,105990,-19169889
3788,0,Biography,11634362,Girl with a Pearl Earring,100,7.0,63882,11634362
3789,130000000,Action,138608444,Bad Boys II,147,6.6,190484,8608444
3790,55000000,Comedy,104565114,American Wedding,96,6.3,171577,49565114
3791,30000000,Comedy,41407470,Secondhand Lions,111,7.6,45722,11407470
3792,26000000,Horror,46961214,Final Destination 2,90,6.2,129165,20961214
3793,20000000,Crime,16248701,21 Grams,124,7.7,200427,-3751299
3794,50000000,Crime,19593740,The Life of David Gale,130,7.6,94693,-30406260
3795,2800000,Crime,14131,Memories of Murder,131,8.1,80301,-2785869
3796,15000000,Drama,13005485,House of Sand and Fog,126,7.6,58778,-1994515
3797,17000000,Adventure,42672630,The Lizzie McGuire Movie,94,5.4,30128,25672630
3798,29000000,Action,56359780,Once Upon a Time in Mexico,102,6.4,137276,27359780
3799,60000000,Action,31186896,The Core,135,5.5,81258,-28813104
3800,48000000,Comedy,110003217,Scary Movie 3,84,5.5,118792,62003217
3801,65000000,Drama,63860942,Mona Lisa Smile,117,6.4,65841,-1139058
3802,10000000,Drama,365734,The Brown Bunny,93,5.0,12152,-9634266
3803,75000000,Comedy,135645823,Anger Management,106,6.2,180365,60645823
3804,35000000,Comedy,20298207,Down with Love,101,6.3,34946,-14701793
3805,30000000,Drama,5381227,The Human Stain,106,6.3,26598,-24618773
3806,120000,Adventure,30610863,Open Water,79,5.7,44989,30490863
3807,0,Crime,3681066,High Tension,91,6.8,58572,3681066
3808,18000000,Comedy,43610723,Under the Tuscan Sun,113,6.8,39134,25610723
3809,70000000,Action,43734876,Tears of the Sun,121,6.6,99418,-26265124
3810,75000000,Action,30013346,Hollywood Homicide,116,5.3,32542,-44986654
3811,38000000,Action,111761982,Spy Kids 3: Game Over,84,4.2,44074,73761982
3812,60000000,Animation,26483452,Sinbad: Legend of the Seven Seas,85,6.7,39745,-33516548
3813,20000000,Comedy,35990505,What a Girl Wants,105,5.8,51247,15990505
3814,60000000,Adventure,26900336,The Missing,137,6.5,29091,-33099664
3815,80000000,Comedy,124728738,Something's Gotta Give,128,6.7,96603,44728738
3816,40000000,Horror,59694580,Gothika,98,5.8,94370,19694580
3817,80000000,Action,116934650,S.W.A.T.,117,6.0,125305,36934650
3818,35000000,Action,28082366,Johnny English,100,6.1,121464,-6917634
3819,26000000,Action,47811138,Agent Cody Banks,102,5.0,28662,21811138
3820,90000000,Comedy,75847266,The Haunted Mansion,100,4.9,34691,-14152734
3821,50000000,Action,26536120,Básico y letal,98,6.5,52747,-23463880
3822,23000000,Comedy,60060328,Bad Santa,91,7.1,118278,37060328
3823,30000000,Comedy,15589458,View from the Top,87,5.2,22332,-14410542
3824,60000000,Action,53790451,Paycheck,119,6.3,93707,-6209549
3825,0,Crime,10105505,Swimming Pool: juegos perversos,102,6.8,36993,10105505
3826,62000000,Comedy,36906460,Matchstick Men,116,7.3,111886,-25093540
3827,60000000,Comedy,104297061,Daddy Day Care,92,5.5,53301,44297061
3828,46000000,Action,52802140,The Recruit,115,6.6,118822,6802140
3829,3000000,Crime,1227000,Elephant,81,7.2,75039,-1773000
3830,128000000,Animation,85336277,Tierra de osos,85,6.8,77498,-42663723
3831,0,Mystery,21384035,Cold Creek Manor,118,4.9,19082,21384035
3832,36000000,Action,26183197,A Man Apart,109,6.1,40381,-9816803
3833,16000000,Comedy,34308901,Malibu's Most Wanted,100,5.1,16779,18308901
3834,33000000,Comedy,132716677,Bringing Down the House,105,5.6,31366,99716677
3835,35000000,Adventure,4426297,Más allá de las fronteras,127,6.5,23761,-30573703
3836,80000000,Action,19481943,Timeline,116,5.6,55054,-60518057
3837,0,Comedy,4064200,Good Bye Lenin!,121,7.7,121190,4064200
3838,80000000,Animation,20991364,Looney Tunes: Back in Action,100,5.7,26853,-59008636
3839,50000000,Action,40905277,Out of Time,105,6.5,49072,-9094723
3840,5000000,Crime,1056102,Wonderland,104,6.6,19416,-3943898
3841,60000000,Drama,49443628,Runaway Jury,127,7.1,80544,-10556372
3842,55000000,Comedy,33832741,Stuck on You,118,5.8,46442,-21167259
3843,60000000,Action,66934963,Kangaroo Jack,89,4.4,25060,6934963
3844,60000000,Comedy,35327628,Intolerable Cruelty,100,6.3,80789,-24672372
3845,11000000,Horror,32551396,Darkness Falls,86,5.0,27228,21551396
3846,18000000,Drama,30222640,Honey,94,5.3,38850,12222640
3847,0,Comedy,548707,Love Me If You Dare,93,7.7,59405,548707
3848,54000000,Comedy,6068735,Gigli,121,2.4,42890,-47931265
3849,12000000,Mystery,4750602,In the Cut,119,5.3,19446,-7249398
3850,38000000,Horror,7659747,The Order,102,5.2,15575,-30340253
3851,55000000,Action,34238611,The Hunted,94,6.0,37835,-20761389
3852,19000000,Comedy,26276465,Dumb and Dumberer: When Harry Met Lloyd,85,3.4,32064,7276465
3853,18000000,Comedy,56127162,Just Married,95,5.4,60573,38127162
3854,50000000,Action,60476872,Shanghai Knights,114,6.2,87352,10476872
3855,45000000,Comedy,90186328,"Legally Blonde 2: Red, White & Blonde",95,4.7,50536,45186328
3856,87000000,Drama,120277854,Seabiscuit,140,7.3,59979,33277854
3857,20000000,Comedy,36922190,Uptown Girls,92,6.1,30845,16922190
3858,0,Drama,502028,The Return,105,8.0,34054,502028
3859,0,Adventure,5111630,Grind,105,6.0,10746,5111630
3860,0,Comedy,1971135,Coffee and Cigarettes,95,7.1,50777,1971135
3861,500000,Comedy,5739376,The Station Agent,89,7.7,61005,5239376
3862,7000000,Action,10249719,House of the Dead,90,2.0,33277,3249719
3863,30000000,Action,34604054,Cradle 2 the Grave,101,5.8,36878,4604054
3864,0,Drama,15280,Evil,113,7.8,31763,15280
3865,0,Biography,5791328,Lutero,123,6.6,13382,5791328
3866,35000000,Biography,52277485,Radio,109,6.9,33842,17277485
3867,0,Comedy,21897389,Love Don't Cost a Thing,100,5.1,6039,21897389
3868,41000000,Action,22108977,The Medallion,88,5.2,32750,-18891023
3869,0,Action,35764982,National Security,88,5.6,41326,35764982
3870,56000000,Biography,12870569,Gods and Generals,219,6.3,13829,-43129431
3871,0,Comedy,6126237,Chasing Papi,80,4.8,3577,6126237
3872,6000000,Drama,2220008,Shattered Glass,94,7.2,30173,-3779992
3873,20000000,Comedy,15408822,A Guy Thing,101,5.6,14915,-4591178
3874,0,Drama,9074550,The Divorce,100,4.9,10084,9074550
3875,22000000,Drama,6886089,Willard,100,6.2,15832,-15113911
3876,0,Comedy,1628154,Camp,114,6.3,5242,1628154
3877,0,Action,74864,Ned Kelly,110,6.5,22829,74864
3878,12000000,Comedy,4922166,From Justin to Kelly,81,2.1,23990,-7077834
3879,5000000,Biography,728253,Party Monster,98,6.3,13310,-4271747
3880,18000000,Comedy,3203044,Anything Else,108,6.4,26603,-14796956
3881,52000000,Action,23020488,Bulletproof Monk,104,5.5,43940,-28979512
3882,0,Biography,1302242,Sylvia,110,6.3,9321,1302242
3883,0,Action,4560061,Ong-Bak: The Thai Warrior,105,7.2,63887,4560061
3884,0,Crime,767240,Young Adam,98,6.5,12050,767240
3885,40000000,Action,20440627,The In-Laws,100,5.7,14598,-19559373
3886,25000000,Animation,39399750,Rugrats Go Wild,100,5.6,6205,14399750
3887,35200000,Comedy,37788228,Head of State,95,5.4,15690,2588228
3888,9500000,Animation,7002255,The Triplets of Belleville,80,7.8,44860,-2497745
3889,17000000,Comedy,22734486,Dickie Roberts: Former Child Star,98,5.6,12287,5734486
3890,0,Drama,254224,The Best of Youth,366,8.5,17585,254224
3891,2500000,Drama,548712,All the Real Girls,108,6.9,9474,-1951288
3892,40000000,Comedy,9692135,Duplex,89,5.9,48829,-30307865
3893,780000,Action,1310470,Saints and Soldiers,90,6.8,18516,530470
3894,0,Animation,128985,Tokyo Godfathers,100,7.9,22266,128985
3895,10000000,Comedy,31041759,Calendar Girls,108,6.9,20538,21041759
3896,8000000,Drama,1174139,I Capture the Castle,113,7.1,6060,-6825861
3897,0,Comedy,26300,Barely Legal,100,4.8,5524,26300
3898,0,Drama,284002,I Am David,90,7.3,6485,284002
3899,15000000,Crime,12212417,Confidence,97,6.7,31315,-2787583
3900,3200000,Crime,8243880,The Cooler,101,7.0,29549,5043880
3901,0,Comedy,17508936,A Mighty Wind,91,7.3,23253,17508936
3902,0,Action,21701045,Biker Boyz,110,4.6,11532,21701045
3903,0,Comedy,1787378,Kal Ho Naa Ho,186,8.0,51400,1787378
3904,0,Biography,6003587,American Splendor,101,7.5,43575,6003587
3905,0,Comedy,7375836,It Runs in the Family,100,5.6,4199,7375836
3906,17000000,Biography,1571504,Veronica Guerin,98,6.9,17055,-15428496
3907,4000000,Comedy,732241,The Shape of Things,96,6.7,10052,-3267759
3908,0,Drama,343816,The United States of Leland,108,7.1,20860,343816
3909,300000,Comedy,2528664,Pieces of April,80,7.1,18540,2228664
3910,850000,Comedy,819939,Latter Days,107,7.1,15271,-30061
3911,0,Comedy,2483,The Green Butchers,100,7.3,16028,2483
3912,14000000,Comedy,15550605,My Boss's Daughter,86,4.7,25363,1550605
3913,16000000,Comedy,14108518,How to Deal,100,5.6,8473,-1891482
3914,0,Action,497208,Taxi 3,84,5.8,33795,497208
3915,0,Drama,213954,Carandiru,145,7.6,15107,213954
3916,20000000,Animation,47887943,The Jungle Book 2,72,5.4,12558,27887943
3917,0,Drama,2380788,"Spring, Summer, Fall, Winter... and Spring",103,8.1,66713,2380788
3918,8000000,Comedy,336456,The Singing Detective,109,5.6,7414,-7663544
3919,0,Comedy,56127,Dorm Daze,96,4.6,7089,56127
3920,17000000,Comedy,37566230,Good Boy!,100,5.1,3591,20566230
3921,0,Drama,1062253,The Mother,112,6.9,3593,1062253
3922,0,Comedy,237183,Kontroll,107,7.7,21046,237183
3923,0,Drama,54523,29 palmas - Pasiones salvajes,114,5.2,3679,54523
3924,15000000,Comedy,30238577,The Fighting Temptations,123,5.5,6052,15238577
3925,0,Drama,61439,Time of the Wolf,114,6.6,8044,61439
3926,0,Drama,395592,La vida sin mí,106,7.6,22023,395592
3927,0,Action,41196,Undead,100,5.5,11798,41196
3928,5000000,Comedy,896993,Intermission,105,6.9,14096,-4103007
3929,7500000,Drama,197148,Code 46,93,6.2,18738,-7302852
3930,0,Comedy,931755,Bright Young Things,102,6.6,4557,931755
3931,0,Comedy,3432342,The Barbarian Invasions,99,7.7,25849,3432342
3932,0,Crime,54419,Gozu,130,7.1,9463,54419
3933,6800000,Crime,33225,Shade,101,6.4,11130,-6766775
3934,0,Biography,4068087,The Visual Bible: The Gospel of John,180,7.7,2335,4068087
3935,0,Action,853718,The Blind Swordsman: Zatoichi,116,7.6,42734,853718
3936,15000000,Drama,2281585,The Company,112,6.4,5757,-12718415
3937,0,Animation,23103423,Piglet's Big Movie,75,6.0,5240,23103423
3938,0,Drama,681000,Koi... Mil Gaya,171,7.1,16125,681000
3939,0,Comedy,377271,Pride and Prejudice,100,5.3,2156,377271
3940,30000000,Comedy,14208384,Alex & Emma,100,5.6,11953,-15791616
3941,5740000,Drama,647054,Japanese Story,105,6.7,5814,-5092946
3942,15000000,Action,19067,Stander,116,7.2,7443,-14980933
3943,10000000,Crime,1011054,Owning Mahowny,104,7.1,11120,-8988946
3944,0,Crime,1615118,I'm Not Scared,108,7.5,12805,1615118
3945,0,Comedy,14811,Easy,100,5.9,1509,14811
3946,0,Crime,358804,I'll Sleep When I'm Dead,102,5.9,7764,358804
3947,20000,Drama,7221,Zero Day,92,7.3,3594,-12779
3948,0,Comedy,17334912,Deliver Us from Eva,105,6.1,4889,17334912
3949,0,Drama,20838,Nathalie...,100,6.3,4052,20838
3950,0,Drama,6140,It's All About Love,100,5.5,7357,6140
3951,0,Drama,306224,Dot the I,100,6.8,7701,306224
3952,0,Comedy,533344,Masked and Anonymous,112,5.5,4094,533344
3953,0,Drama,482357,Strayed,95,6.6,2816,482357
3954,0,Biography,365727,Baadasssss!,108,7.4,4384,365727
3955,0,Drama,836225,Chalte Chalte,167,6.6,12435,836225
3956,0,Drama,72762,Reconstruction,91,7.4,6465,72762
3957,0,Drama,34720,"Goodbye, Dragon Inn",82,7.1,3091,34720
3958,1000000,Drama,279282,The Battle of Shaker Heights,100,6.1,3926,-720718
3959,0,Action,332015,The Memory of a Killer,123,7.4,8593,332015
3960,29000000,Drama,81001787,The Notebook,123,7.9,430711,52001787
3961,1200000,Horror,56000369,Saw,103,7.7,322727,54800369
3962,175000000,Drama,133378256,Troy,163,7.2,414038,-41621744
3963,60000000,Drama,114197520,The Village,108,6.5,209350,54197520
3964,66000000,Action,59623958,Hellboy,122,6.8,261530,-6376042
3965,17000000,Comedy,86058055,Mean Girls,97,7.0,270476,69058055
3966,130000000,Adventure,249358727,Harry Potter and the Prisoner of Azkaban,142,7.8,427343,119358727
3967,92000000,Animation,261441092,The Incredibles,115,8.0,520926,169441092
3968,20000000,Drama,34400301,Eternal Sunshine of the Spotless Mind,108,8.3,736127,14400301
3969,125000000,Action,186740799,The Day After Tomorrow,124,6.4,356977,61740799
3970,30000000,Action,66208183,Kill Bill: Vol. 2,137,8.0,555508,36208183
3971,33000000,Action,33682273,The Punisher,124,6.5,132115,682273
3972,25000000,Comedy,17718223,EuroTrip,93,6.6,171296,-7281777
3973,0,Comedy,13542874,Shaun of the Dead,99,8.0,428784,13542874
3974,160000000,Action,120177084,Van Helsing,131,6.0,211483,-39822916
3975,70000000,Drama,51268815,The Phantom of the Opera,143,7.3,102339,-18731185
3976,25000000,Comedy,14589444,The Girl Next Door,108,6.8,180214,-10410556
3977,37000000,Comedy,70831760,White Chicks,109,5.5,107599,33831760
3978,5000000,Drama,1082715,The Machinist,101,7.7,304458,-3917285
3979,6500000,Crime,54580300,Crash,112,7.8,379156,48080300
3980,400000,Comedy,44540956,Napoleon Dynamite,96,6.9,171007,44140956
3981,0,Biography,5509040,Downfall,156,8.3,272105,5509040
3982,30000000,Drama,100492203,Million Dollar Baby,132,8.1,528910,70492203
3983,13000000,Sci-Fi,57938693,The Butterfly Effect,113,7.7,387284,44938693
3984,12000000,Comedy,17083732,Chucky 5: El Hijo de Chucky,87,4.9,31029,5083732
3985,0,Crime,2338695,Layer Cake,105,7.4,142359,2338695
3986,26000000,Action,59020957,Dawn of the Dead,101,7.3,206262,33020957
3987,30000000,Drama,370782930,The Passion of the Christ,127,7.2,189031,340782930
3988,50000000,Adventure,24006726,The Life Aquatic with Steve Zissou,119,7.3,151463,-25993274
3989,27000000,Drama,33987757,Closer,104,7.3,177735,6987757
3990,24000000,Animation,4711096,Howl's Moving Castle,119,8.2,242412,-19288904
3991,110000000,Biography,102608827,El aviador,170,7.5,284387,-7391173
3992,20000000,Comedy,114326736,Dodgeball: A True Underdog Story,92,6.7,198343,94326736
3993,120000000,Action,51882244,King Arthur,126,6.3,144158,-68117756
3994,140000000,Adventure,118627117,A Series of Unfortunate Events,108,6.8,172422,-21372883
3995,37000000,Comedy,57231747,13 Going on 30,98,6.1,132486,20231747
3996,25000000,Biography,51680613,Finding Neverland,106,7.7,182038,26680613
3997,200000000,Action,373585825,Spider-Man 2,127,7.3,451467,173585825
3998,65000000,Crime,101005703,Collateral,115,7.6,312190,36005703
3999,120000000,Action,144801023,"I, Robot",115,7.1,423244,24801023
4000,75000000,Action,176241941,The Bourne Supremacy,108,7.8,379648,101241941
4001,150000000,Animation,436471036,Shrek 2,93,7.2,342666,286471036
4002,70000000,Action,77911774,Man on Fire,146,7.7,285049,7911774
4003,155000000,Action,34297191,Alexander,175,5.5,146107,-120702809
4004,105000000,Action,57761012,The Chronicles of Riddick,119,6.7,193580,-47238988
4005,20000000,Comedy,51438175,A Cinderella Story,95,5.9,68595,31438175
4006,60000000,Comedy,77872883,The Terminal,128,7.3,330983,17872883
4007,12000000,Comedy,71503593,Sideways,126,7.5,158415,59503593
4008,75000000,Comedy,120908074,50 First Dates,99,6.8,283647,45908074
4009,0,Drama,49835,9 Songs,71,4.9,18981,49835
4010,26000000,Comedy,85288303,Anchorman: The Legend of Ron Burgundy,94,7.2,286238,59288303
4011,60000000,Action,80282231,AVP: Alien vs. Predator,101,5.6,157399,20282231
4012,100000000,Action,173008894,National Treasure,131,6.9,268591,73008894
4013,40000000,Comedy,95170481,The Princess Diaries 2: Royal Engagement,113,5.7,59819,55170481
4014,65000000,Action,52411906,Blade: Trinity,113,5.9,143476,-12588094
4015,30000000,Action,61188085,Juego de viernes por la noche,118,7.3,50432,31188085
4016,110000000,Crime,125544280,Ocean's Twelve,125,6.5,305800,15544280
4017,42000000,Comedy,88097164,Along Came Polly,90,5.9,111747,46097164
4018,25000000,Drama,14161590,Dirty Dancing: Havana Nights,86,6.0,23521,-10838410
4019,7000,Drama,424760,Primer,77,6.9,81468,417760
4020,9000000,Adventure,18225165,Harold & Kumar Go to White Castle,88,7.1,163200,9225165
4021,30000000,Action,32774834,Team America: World Police,98,7.2,142880,2774834
4022,35000000,Comedy,22918387,Ella Enchanted,96,6.3,51752,-12081613
4023,2500000,Comedy,26782316,Garden State,102,7.5,194118,24282316
4024,90000000,Comedy,59484742,The Stepford Wives,93,5.2,52194,-30515258
4025,10000000,Comedy,9436390,Sleepover,89,5.3,13433,-563610
4026,10000000,Horror,110359362,The Grudge,91,5.9,123089,100359362
4027,15000000,Comedy,29331068,Confessions of a Teenage Drama Queen,89,4.6,24586,14331068
4028,165000000,Animation,183373735,The Polar Express,100,6.6,134170,18373735
4029,45000000,Action,51201453,Resident Evil: Apocalypse,94,6.2,164937,6201453
4030,2700000,Drama,5792822,Before Sunset,80,8.0,183175,3092822
4031,17500000,Biography,23472900,Hotel Rwanda,121,8.1,286561,5972900
4032,40000000,Mystery,48022900,Secret Window,96,6.6,157858,8022900
4033,80000000,Comedy,279261160,Meet the Fockers,115,6.3,223589,199261160
4034,80000000,Drama,65955630,The Manchurian Candidate,129,6.6,91522,-14044370
4035,75000000,Animation,160861908,Shark Tale,90,6.0,142203,85861908
4036,45000000,Crime,32682342,Taking Lives,103,6.2,69195,-12317658
4037,100000000,Action,40202379,Catwoman,104,3.3,93348,-59797621
4038,20000000,Action,17108591,Kung Fu Hustle,99,7.8,106883,-2891409
4039,35000000,Comedy,39799191,The Ladykillers,104,6.2,88680,4799191
4040,56000000,Action,45860039,Walking Tall,86,6.2,57133,-10139961
4041,80000000,Animation,84216833,Scooby-Doo 2: Monsters Unleashed,93,5.0,36847,4216833
4042,80000000,Comedy,42044321,Spanglish,131,6.4,69272,-37955679
4043,70000000,Action,37760080,Sky Captain and the World of Tomorrow,106,6.1,75399,-32239920
4044,110000000,Action,24008137,Around the World in 80 Days,120,5.8,73536,-85991863
4045,30000000,Animation,85417988,The SpongeBob SquarePants Movie,87,7.0,64107,55417988
4046,28000000,Biography,64378093,Miracle,135,7.5,39178,36378093
4047,40000000,Biography,75331600,Ray,152,7.7,118242,35331600
4048,40000000,Comedy,40226215,Bridget Jones: The Edge of Reason,108,5.9,86030,226215
4049,0,Biography,2086345,The Sea Inside,125,8.0,68461,2086345
4050,15000000,Family,10411980,Raise Your Voice,100,5.9,23974,-4588020
4051,47000000,Drama,6167817,A Very Long Engagement,133,7.7,65330,-40832183
4052,30000000,Drama,12831121,Wicker Park,114,7.0,47335,-17168879
4053,25000000,Action,36611066,Taxi,97,4.4,35086,11611066
4054,0,Comedy,28165882,The Prince and Me,111,5.9,33861,28165882
4055,60000000,Comedy,88237754,Starsky & Hutch,101,6.1,125648,28237754
4056,45000000,Action,21009180,Flight of the Phoenix,113,6.1,47448,-23990820
4057,23000000,Comedy,12189514,Chasing Liberty,101,6.1,31901,-10810486
4058,0,Drama,697181,Mysterious Skin,105,7.7,59675,697181
4059,18000000,Adventure,16702864,Catch That Kid,91,5.2,8514,-1297136
4060,31000000,Comedy,17001133,Wimbledon,98,6.3,54188,-13998867
4061,3500000,Action,96793,D.E.B.S.,91,5.3,12868,-3403207
4062,25000000,Action,32003620,Cellular,94,6.5,82822,7003620
4063,0,Crime,6013,Dead Man's Shoes,90,7.7,42662,6013
4064,27000000,Crime,4480744,La isla maldita,106,6.4,51913,-22519256
4065,22000000,Comedy,12784713,I Heart Huckabees,107,6.7,58556,-9215287
4066,35000000,Animation,75369589,Garfield,80,5.0,64907,40369589
4067,0,Action,1197786,District B13,84,7.2,58967,1197786
4068,11000000,Biography,10214647,Kinsey,118,7.1,44032,-785353
4069,42000000,Drama,66641205,The Forgotten,91,5.8,59556,24641205
4070,19000000,Adventure,58169327,Without a Paddle,95,5.9,39199,39169327
4071,0,Adventure,16756372,The Motorcycle Diaries,126,7.8,87264,16756372
4072,35000000,Comedy,25266129,Jersey Girl,102,6.2,57178,-9733871
4073,0,Action,11050094,House of Flying Daggers,119,7.6,96858,11050094
4074,23000000,Drama,16136476,Vanity Fair,141,6.2,18147,-6863524
4075,12000000,Drama,261481,2046,129,7.5,44039,-11738519
4076,16000000,Comedy,13922211,Soul Plane,86,4.4,19204,-2077789
4077,57000000,Action,6768055,Thunderbirds,95,4.2,11740,-50231945
4078,50000000,Horror,41821986,Exorcist: The Beginning,114,5.1,29891,-8178014
4079,8600000,Comedy,4992159,Club Dread,104,5.7,24974,-3607841
4080,24000000,Comedy,17071962,Win a Date with Tad Hamilton!,100,5.6,23925,-6928038
4081,40000000,Comedy,10387706,The Perfect Score,93,5.7,20826,-29612294
4082,5000000,Comedy,8940582,Saved!,92,6.8,41580,3940582
4083,100000000,Action,67286731,Hidalgo,136,6.7,70672,-32713269
4084,500000,Crime,603951,Mean Creek,90,7.3,27763,103951
4085,8000000,Drama,40066497,You Got Served,95,3.5,24154,32066497
4086,60000000,Comedy,73780539,Christmas with the Kranks,99,5.2,30985,13780539
4087,58000000,Action,28328132,After the Sunset,97,6.3,40092,-29671868
4088,40000000,Action,21215059,Torque,84,4.0,24682,-18784941
4089,0,Drama,4835065,The Libertine,114,6.4,32405,4835065
4090,23000000,Biography,6318709,Beyond the Sea,118,6.7,13453,-16681291
4091,15000000,Comedy,1339668,A Dirty Shame,89,5.1,11124,-13660332
4092,30000000,Comedy,14018364,New York Minute,100,4.9,18830,-15981636
4093,30000000,Comedy,9055010,First Daughter,100,5.0,18324,-20944990
4094,18000000,Drama,3765585,The Merchant of Venice,131,7.1,31158,-14234415
4095,20000000,Drama,5005883,Birth,100,6.1,31210,-14994117
4096,5000000,Crime,5211842,Bad Education,106,7.5,48212,211842
4097,60000000,Comedy,13399812,Alfie,103,6.2,45684,-46600188
4098,0,Drama,992238,My Summer of Love,86,6.8,17239,992238
4099,7000000,Comedy,6601079,Bride & Prejudice,111,6.2,18188,-398921
4100,50000000,Comedy,6471394,The Big Bounce,88,4.9,16502,-43528606
4101,26000000,Action,23222861,Agent Cody Banks 2: Destination London,100,4.5,12029,-2777139
4102,0,Action,548039,The Final Cut,95,6.2,28056,548039
4103,50000000,Comedy,57890460,Shall We Dance,106,6.1,37878,7890460
4104,107000000,Drama,22414961,The Alamo,137,6.0,17664,-84585039
4105,55000000,Action,74541707,Ladder 49,115,6.5,50406,19541707
4106,25000000,Action,32238923,Anacondas: The Hunt for the Blood Orchid,97,4.6,23961,7238923
4107,50000000,Comedy,37486138,Raising Helen,119,6.0,32370,-12513862
4108,0,Drama,3635164,The Chorus,97,7.9,47812,3635164
4109,0,Drama,40601,The Woodsman,87,7.2,28874,40601
4110,0,Drama,144065,Before the Fall,117,7.4,11986,144065
4111,20000000,Comedy,9109322,Superbabies: Baby Geniuses 2,88,2.0,26818,-10890678
4112,0,Animation,1043896,Ghost in the Shell 2: Innocence,100,7.6,30980,1043896
4113,40000000,Comedy,12181484,Envy,99,4.8,27466,-27818516
4114,40000000,Comedy,16323969,The Whole Ten Yards,98,5.5,48262,-23676031
4115,20000000,Biography,13337299,De-Lovely,125,6.6,10018,-6662701
4116,0,Drama,159171,A Love Song for Bobby Long,119,7.2,23027,159171
4117,4200000,Action,1487477,Night Watch,114,6.5,48808,-2712523
4118,7000000,Drama,2921738,Veer-Zaara,192,7.9,39916,-4078262
4119,50000000,Crime,25195050,Twisted,97,5.2,18006,-24804950
4120,0,Adventure,18947630,Two Brothers,109,7.1,12650,18947630
4121,110000000,Animation,50030461,Home on the Range,76,5.4,15266,-59969539
4122,0,Drama,29058,The Heart Is Deceitful Above All Things,98,6.6,5569,29058
4123,26000000,Comedy,45489752,In Good Company,100,6.5,50314,19489752
4124,26000000,Comedy,48116322,Fat Albert,93,4.3,9859,22116322
4125,0,Comedy,175408,P.S.,97,6.3,5299,175408
4126,12000000,Comedy,31179516,Johnson Family Vacation,97,4.4,6299,19179516
4127,0,Comedy,3835551,The Door in the Floor,111,6.7,13913,3835551
4128,0,Drama,92214,Amor o sexo,106,6.8,6621,92214
4129,5000000,Horror,101107,Riding the Bullet,100,5.2,7968,-4898893
4130,0,Horror,75829,Three... Extremes,118,7.0,16728,75829
4131,19250000,Action,4434432,Spartan,102,6.6,27340,-14815568
4132,0,Drama,398278,Head in the Clouds,121,6.6,13138,398278
4133,0,Biography,2694071,Bobby Jones: Stroke of Genius,129,6.7,3364,2694071
4134,0,Drama,70395,Ma mère,110,5.1,5331,70395
4135,28000000,Comedy,17848322,Las leyes de atracción,90,5.9,19776,-10151678
4136,3000000,Crime,6517198,Maria Full of Grace,101,7.5,31546,3517198
4137,0,Crime,121166,Lila Says,89,7.0,4054,121166
4138,8000000,Comedy,365134,She Hate Me,138,5.3,6600,-7634866
4139,0,Comedy,95016,Summer Storm,98,7.4,11810,95016
4140,0,Comedy,6583149,Millions,98,6.9,22743,6583149
4141,6000000,Comedy,371081,House of D,96,7.0,7919,-5628919
4142,0,Crime,34000,Black Friday,143,8.6,13141,34000
4143,35000000,Comedy,20422207,Little Black Book,111,5.3,15844,-14577793
4144,0,Comedy,3825351,Melinda and Melinda,99,6.5,28468,3825351
4145,0,Biography,120620,It's All Gone Pete Tong,90,7.4,17570,120620
4146,11000000,Crime,3753806,Vera Drake,125,7.7,21213,-7246194
4147,0,Drama,6759422,Ladies in Lavender,104,7.1,8937,6759422
4148,0,Drama,24947,Undertow,108,6.7,7587,24947
4149,0,Comedy,9910,As It Is in Heaven,133,7.6,14388,9910
4150,6500000,Comedy,70527,Eulogy,91,6.7,7932,-6429473
4151,26000000,Comedy,14469428,Welcome to Mooseport,110,5.2,11058,-11530572
4152,0,Drama,1223240,Swades,195,8.3,66309,1223240
4153,0,Comedy,1186323,Saving Face,91,7.5,8312,1186323
4154,27000000,Crime,8725813,Suspect Zero,100,5.9,17171,-18274187
4155,50000,Comedy,155212,Eating Out,90,5.9,5354,105212
4156,0,Drama,1340891,Dear Frankie,105,7.8,19530,1340891
4157,0,Drama,358262,Enduring Love,100,6.4,9152,358262
4158,25000000,Drama,14379751,Godsend,102,4.8,23154,-10620249
4159,0,Drama,5763875,The Clearing,95,5.9,12195,5763875
4160,0,Action,367027,Highwaymen,80,5.7,7657,367027
4161,0,Comedy,795126,Saint Ralph,98,7.6,5291,795126
4162,0,Comedy,21864,Rory O'Shea Was Here,104,7.9,12466,21864
4163,18000000,Comedy,65111277,Barbershop 2: Back in Business,106,5.7,11281,47111277
4164,18000000,Comedy,7739049,"Julia, una mujer seductora",104,7.0,11052,-10260951
4165,0,Drama,256822,Turtles Can Fly,98,8.1,14720,256822
4166,3000000,Drama,2037545,We Don't Live Here Anymore,101,6.3,8531,-962455
4167,0,Drama,223144,A Good Woman,93,6.5,10196,223144
4168,0,Drama,188248,Eros,104,6.0,5387,188248
4169,1000000,Crime,238507,3-Iron,88,8.1,41640,-761493
4170,30000000,Comedy,21800302,Mr 3000,104,5.5,12740,-8199698
4171,0,Horror,2623,Calvaire,88,6.2,10084,2623
4172,0,Drama,776691,Stage Beauty,106,7.2,9141,776691
4173,0,Comedy,553368,Palindromes,100,6.8,11133,553368
4174,12000000,Biography,195378,Modigliani,128,7.4,9098,-11804622
4175,45000000,Comedy,11663156,Surviving Christmas,91,5.3,18771,-33336844
4176,20000000,Comedy,8054280,Connie and Carla,108,6.3,7171,-11945720
4177,0,Animation,410388,Steamboy,126,6.9,14575,410388
4178,6500000,Drama,1029872,A Home at the End of the World,97,6.8,12420,-5470128
4179,20000000,Animation,19762690,Yu-Gi-Oh!: The Movie,100,4.6,6776,-237310
4180,40000000,Drama,29077547,Rent,135,7.0,43683,-10922453
4181,150000000,Adventure,206459076,Charlie and the Chocolate Factory,115,6.7,350762,56459076
4182,150000000,Adventure,290013036,Harry Potter and the Goblet of Fire,157,7.7,429209,140013036
4183,150000000,Action,206852432,Batman Begins,152,8.3,1075968,56852432
4184,40000000,Action,25514517,Serenity,119,7.9,255155,-14485483
4185,54000000,Action,70511035,V for Vendetta,132,8.2,867117,16511035
4186,40000000,Crime,74103820,Sin City,124,8.0,690034,34103820
4187,28000000,Drama,38405088,Pride & Prejudice,129,7.8,209548,10405088
4188,50000000,Adventure,51085416,The Hitchhiker's Guide to the Galaxy,109,6.8,165212,1085416
4189,14000000,Drama,83043761,Brokeback Mountain,134,7.7,276758,69043761
4190,40000000,Comedy,209218368,Wedding Crashers,119,7.0,295346,169218368
4191,180000000,Adventure,291709845,"The Chronicles of Narnia: The Lion, the Witch and the Wardrobe",143,6.9,310549,111709845
4192,82000000,Comedy,158119460,The Longest Yard,113,6.4,139788,76119460
4193,4800000,Horror,47326473,Hostel,94,5.9,147832,42526473
4194,130000000,Action,47398413,Kingdom of Heaven,144,7.2,232742,-82601587
4195,113000000,Action,380262555,Star Wars: Episode III - Revenge of the Sith,140,7.6,570398,267262555
4196,132000000,Adventure,234280354,War of the Worlds,116,6.5,357995,102280354
4197,100000000,Drama,75976178,Constantine,121,6.9,253723,-24023822
4198,43000000,Action,24409722,Elektra,97,4.8,75843,-18590278
4199,28000000,Biography,119519402,Walk the Line,136,7.9,198923,91519402
4200,0,Adventure,26024456,The Descent,99,7.2,167959,26024456
4201,19000000,Drama,65233369,The Amityville Horror,90,6.0,91483,46233369
4202,70000000,Comedy,179495555,Hitch,118,6.6,259673,109495555
4203,207000000,Action,218080025,King Kong,187,7.2,340976,11080025
4204,26000000,Comedy,109449237,The 40-Year-Old Virgin,116,7.1,334507,83449237
4205,120000000,Action,186336279,Mr. & Mrs. Smith,120,6.5,379073,66336279
4206,4000000,Horror,87039965,Saw II,93,6.6,201006,83039965
4207,1500000,Comedy,7362100,The Squid and the Whale,81,7.4,64252,5862100
4208,7000000,Crime,17044981,The Devil's Rejects,107,6.9,80744,10044981
4209,40000000,Animation,53359111,Corpse Bride,77,7.4,205383,13359111
4210,35000000,Adventure,63946815,Sky High,100,6.2,66438,28946815
4211,126000000,Action,35818913,The Island,136,6.9,275721,-90181087
4212,15000000,Comedy,31726995,The Wedding Date,90,6.1,41497,16726995
4213,0,Crime,344095,Green Street Hooligans,109,7.5,125881,344095
4214,88000000,Biography,61649911,Cinderella Man,144,8.0,156991,-26350089
4215,72000000,Action,62658220,Jarhead,125,7.0,152251,-9341780
4216,70000000,Crime,47403685,Munich,164,7.6,186355,-22596315
4217,53000000,Comedy,56046979,Be Cool,118,5.7,61786,3046979
4218,52000000,Action,34639939,Hostage,113,6.6,97552,-17360061
4219,32000000,Crime,31493782,A History of Violence,96,7.5,198947,-506218
4220,100000000,Action,154696080,Fantastic Four,106,5.7,280250,54696080
4221,15000000,Drama,23089926,Match Point,124,7.7,178918,8089926
4222,65000000,Action,29258869,Zathura: A Space Adventure,101,6.1,74238,-35741131
4223,25000000,Comedy,47144110,Nanny McPhee,97,6.6,55077,22144110
4224,75000000,Animation,193595521,Madagascar,86,6.9,294387,118595521
4225,50000000,Action,80270227,The Dukes of Hazzard,104,5.1,68938,30270227
4226,50000000,Crime,24149632,Lord of War,122,7.6,261701,-25850368
4227,950000,Crime,1007962,Hard Candy,104,7.1,138885,57962
4228,55000000,Drama,89707299,Flightplan,98,6.2,134241,34707299
4229,85000000,Drama,57490508,Memoirs of a Geisha,145,7.4,124833,-27509492
4230,20000000,Drama,75072454,The Exorcism of Emily Rose,119,6.7,103356,55072454
4231,30000000,Biography,12712093,The New World,135,6.7,74644,-17287907
4232,30000000,Horror,32064800,La casa de cera,108,5.3,100354,2064800
4233,60000000,Adventure,82571173,Cheaper by the Dozen 2,94,5.5,46237,22571173
4234,45000000,Action,74494381,Four Brothers,109,6.9,117043,29494381
4235,50000000,Action,39177684,The Adventures of Sharkboy and Lavagirl 3-D,93,3.5,22677,-10822316
4236,15000000,Comedy,4243756,Kiss Kiss Bang Bang,103,7.6,188313,-10756244
4237,3000000,Comedy,16124543,Waiting...,94,6.8,79505,13124543
4238,88000000,Adventure,37916267,The Brothers Grimm,118,5.9,103728,-50083733
4239,62000000,Action,25857987,Æon Flux,93,5.5,114477,-36142013
4240,25000000,Comedy,39008741,The Sisterhood of the Traveling Pants,119,6.5,47742,14008741
4241,60000000,Action,26873932,xXx: State of the Union,101,4.4,58727,-33126068
4242,0,Adventure,11294832,Casanova,112,6.5,46586,11294832
4243,26000000,Mystery,57891803,Red Eye,85,6.5,99003,31891803
4244,75000000,Animation,128200012,Robots,91,6.3,111639,53200012
4245,0,Comedy,32619671,Just Friends,96,6.2,88269,32619671
4246,58000000,Comedy,48318130,Just Like Heaven,95,6.7,87397,-9681870
4247,475000,Action,2060589,Brick,110,7.4,89353,1585589
4248,75000000,Action,46464023,The Legend of Zorro,129,5.9,77748,-28535977
4249,30000000,Biography,67264877,Coach Carter,136,7.3,100602,37264877
4250,50000000,Adventure,66023816,Herbie Fully Loaded,101,4.8,38998,16023816
4251,70000000,Comedy,43000262,Rumor Has It...,97,5.5,43996,-26999738
4252,56000000,Action,113086868,The Pacifier,95,5.6,72886,57086868
4253,30000000,Drama,51100486,Hide and Seek,101,5.9,73932,21100486
4254,1000000,Horror,16188180,Wolf Creek,99,6.3,59341,15188180
4255,150000000,Animation,135386665,Chicken Little,81,5.8,70253,-14613335
4256,25000000,Biography,11008432,Lords of Dogtown,107,7.1,46416,-13991568
4257,22000000,Crime,36024076,Derailed,108,6.6,65085,14024076
4258,43000000,Horror,47806295,The Skeleton Key,104,6.5,93583,4806295
4259,50000000,Action,18472363,Into the Blue,110,5.8,66598,-31527637
4260,60000000,Action,28031250,Doom,105,5.2,92480,-31968750
4261,7900000,Comedy,671240,Imagine Me & You,90,6.8,25074,-7228760
4262,0,Action,75420,Revolver,111,6.5,78882,75420
4263,32000000,Action,43095600,Transporter 2,87,6.3,167685,11095600
4264,15000000,Horror,20700082,Tierra de los muertos,93,6.2,82522,5700082
4265,0,Drama,33579797,The Constant Gardener,129,7.5,117703,33579797
4266,7000000,Biography,28747570,Capote,114,7.4,108050,21747570
4267,45000000,Comedy,19377727,The Producers,134,6.4,36654,-25622273
4268,10000000,Comedy,13744960,Broken Flowers,106,7.2,86481,3744960
4269,130000000,Action,68671925,Sahara,124,6.0,81514,-61328075
4270,6500000,Comedy,24792061,Thank You for Smoking,92,7.6,198616,18292061
4271,50000000,Drama,50824620,Syriana,128,7.0,114811,824620
4272,2000000,Action,3337931,Harsh Times,116,6.9,57219,1337931
4273,50000000,Drama,3626883,Stay,99,6.9,65389,-46373117
4274,17500000,Animation,51386611,Hoodwinked!,80,6.5,48853,33886611
4275,17000000,Comedy,60062868,The Family Stone,103,6.3,52044,43062868
4276,29000000,Drama,6303762,Regresiones de un hombre muerto,103,7.1,98068,-22696238
4277,45000000,Comedy,53412862,"Yours, Mine & Ours",88,5.4,23229,8412862
4278,0,Comedy,24381334,Ice Princess,98,6.0,21228,24381334
4279,0,Crime,211667,Lady Vengeance,115,7.6,58692,211667
4280,5500000,Comedy,50633099,Diary of a Mad Black Woman,100,5.7,11095,45133099
4281,0,Drama,3634407,Caché,117,7.3,58915,3634407
4282,20000000,Drama,7524766,Proof,100,6.8,38387,-12475234
4283,50000000,Horror,76231249,The Ring Two,110,5.4,78527,26231249
4284,0,Comedy,1819454,Kinky Boots,107,7.1,15158,1819454
4285,2000000,Crime,1900725,The Proposition,104,7.4,44941,-99275
4286,50000000,Action,10169202,Domino,127,6.0,59944,-39830798
4287,84000000,Comedy,17018422,Son of the Mask,94,2.2,44519,-66981578
4288,30000000,Comedy,21835784,A Lot Like Love,107,6.6,61081,-8164216
4289,60000000,Comedy,82931301,Si te casas... te mato,101,5.5,47280,22931301
4290,30000000,Drama,25473352,Dark Water,105,5.6,53073,-4526648
4291,40000000,Biography,30981850,Get Rich or Die Tryin',117,5.1,38564,-9018150
4292,30000000,Adventure,15007991,The Cave,97,5.1,30287,-14992009
4293,19300000,Drama,66453,Tideland,120,6.5,28341,-19233547
4294,0,Comedy,35424335,The Ringer,94,5.8,32291,35424335
4295,18000000,Horror,29511112,The Fog,100,3.6,30834,11511112
4296,35000000,Drama,18324242,North Country,126,7.3,34660,-16675758
4297,25000000,Biography,5128124,The World's Fastest Indian,127,7.8,46465,-19871876
4298,100000000,Comedy,110332737,Fun with Dick and Jane,90,6.1,117210,10332737
4299,57000000,Comedy,26838389,Elizabethtown,123,6.4,61111,-30161611
4300,7500000,Biography,31501218,"Good Night, and Good Luck.",93,7.5,86894,24001218
4301,8000000,Crime,22201636,Hustle & Flow,116,7.4,34921,14201636
4302,0,Crime,1987287,Oliver Twist,130,6.9,27113,1987287
4303,22000000,Comedy,22264487,Deuce Bigalow: European Gigolo,83,4.6,43334,264487
4304,85000000,Comedy,62252415,Bewitched,102,4.8,61436,-22747585
4305,0,Comedy,32880591,In Her Shoes,130,6.5,54160,32880591
4306,30000000,Animation,56110897,The Curse of the Were-Rabbit,85,7.5,105471,26110897
4307,3200000,Action,54556,Feast,95,6.4,26705,-3145444
4308,20000000,Action,5178569,Alone in the Dark,99,2.3,38854,-14821431
4309,0,Biography,1410778,The Notorious Bettie Page,100,6.6,9362,1410778
4310,15000000,Adventure,5023275,Three Burials,121,7.4,35479,-9976725
4311,0,Comedy,22827153,Prime,105,6.2,36623,22827153
4312,30000000,Adventure,8586392,An Unfinished Life,108,7.0,25594,-21413608
4313,45000000,Action,48478006,Miss Congeniality 2: Armed and Fabulous,115,5.0,56280,3478006
4314,45000000,Action,24520892,Unleashed,103,7.0,89513,-20479108
4315,80000000,Crime,72708161,The Interpreter,128,6.4,89351,-7291839
4316,32000000,Adventure,82674398,Are We There Yet?,95,4.6,24485,50674398
4317,38000000,Comedy,19297522,La marca de la bestia,97,5.0,27364,-18702478
4318,30000000,Comedy,42071069,Fever Pitch,104,6.2,37872,12071069
4319,135000000,Action,32116746,Stealth,121,5.0,47130,-102883254
4320,0,Drama,15331289,The Greatest Game Ever Played,120,7.5,23793,15331289
4321,45000000,Comedy,52580895,Kicking & Screaming,95,5.6,31788,7580895
4322,1500000,Drama,712294,The Ballad of Jack and Rose,100,6.7,9875,-787706
4323,900000,Crime,381186,The Quiet,96,6.4,13952,-518814
4324,0,Drama,12667,London,92,6.6,20156,12667
4325,20000000,Action,19976073,Assault on Precinct 13,109,6.3,68103,-23927
4326,0,Comedy,540085,Romance & Cigarettes,105,6.3,10438,540085
4327,25000000,Crime,871527,Where the Truth Lies,107,6.5,15631,-24128473
4328,35000000,Comedy,68915888,Guess Who,105,5.9,35503,33915888
4329,25000000,Action,2405420,BloodRayne,95,2.9,31478,-22594580
4330,20000000,Drama,46752382,Boogeyman,89,4.1,27378,26752382
4331,0,Action,66851,Beowulf & Grendel,103,5.9,16275,66851
4332,14000000,Comedy,32645546,Because of Winn-Dixie,106,6.4,9001,18645546
4333,2500000,Comedy,305688,Pretty Persuasion,100,6.6,9036,-2194312
4334,10000000,Drama,4280577,Goal! The Dream Begins,118,6.7,53872,-5719423
4335,80000000,Action,10166502,The Great Raid,132,6.7,19340,-69833498
4336,30000000,Comedy,43894863,Must Love Dogs,98,5.9,27405,13894863
4337,1000000,Drama,10047674,Cry_Wolf,90,5.9,23845,9047674
4338,0,Action,11905519,The Protector,83,7.1,31727,11905519
4339,30000000,Comedy,32868349,Bad News Bears,113,5.8,18270,2868349
4340,1000000,Adventure,9015303,Transamerica,103,7.4,37575,8015303
4341,0,Comedy,36351350,Beauty Shop,105,5.5,14248,36351350
4342,0,Comedy,1305,Adam's Apples,94,7.8,38428,1305
4343,33100000,Comedy,16808336,Rebound,86,5.1,11109,-16291664
4344,40000000,Action,19699706,Man of the House,100,5.4,20682,-20300294
4345,20000000,Drama,22862049,Two for the Money,122,6.2,38668,2862049
4346,16000000,Action,3101301,Supercross,80,4.1,4076,-12898699
4347,25000000,Comedy,16247775,The Perfect Man,100,5.5,24927,-8752225
4348,7000000,Comedy,1705595,Everything Is Illuminated,106,7.5,52683,-5294405
4349,30000000,Adventure,49772522,Racing Stripes,102,5.2,13521,19772522
4350,3500000,Comedy,2068323,Strangers with Candy,97,6.1,7228,-1431677
4351,0,Horror,881745,Venom,87,4.7,8454,881745
4352,0,Comedy,202200,Angel-A,91,7.1,27839,202200
4353,1000000,Comedy,2678691,Junebug,106,7.0,19828,1678691
4354,22000000,Comedy,12482775,The Weather Man,102,6.6,71722,-9517225
4355,22000000,Drama,1054361,Joyeux Noel,116,7.8,23393,-20945639
4356,14200000,Drama,78378,Manderlay,139,7.4,19714,-14121622
4357,4000000,Comedy,1325073,Thumbsucker,96,6.6,19354,-2674927
4358,0,Comedy,1311633,Happy Endings,128,6.5,8394,1311633
4359,80000000,Action,1891821,A Sound of Thunder,102,4.2,17129,-78108179
4360,10000000,Drama,56386759,White Noise,101,5.5,43523,46386759
4361,0,Comedy,828699,Breakfast on Pluto,128,7.3,18406,828699
4362,0,Drama,733094,Black,122,8.2,27633,733094
4363,30000000,Drama,251495,Dominion: Prequel to the Exorcist,117,5.3,8626,-29748505
4364,0,Comedy,384924,Little Manhattan,84,7.6,19906,384924
4365,4000000,Adventure,864959,Mirrormask,101,6.9,20947,-3135041
4366,0,Drama,10281585,Shopgirl,106,6.4,21851,10281585
4367,0,Drama,2804642,La mujer de mi hermano,100,6.2,2725,2804642
4368,9000000,Comedy,18761993,The Upside of Anger,100,6.9,19715,9761993
4369,0,Comedy,145450,Dirty Deeds,87,5.9,7723,145450
4370,169000,Comedy,1618957,Keeping Mum,99,6.8,29722,1449957
4371,14000000,Horror,16298046,An American Haunting,83,5.0,22973,2298046
4372,2000000,Comedy,3885134,Me and You and Everyone We Know,91,7.3,32369,1885134
4373,3800000,Horror,167723,Tamara,98,5.2,8649,-3632277
4374,20000000,Comedy,11034436,Mrs Henderson Presents,103,7.1,14000,-8965564
4375,0,Adventure,478070,Lovewrecked,87,4.9,12473,478070
4376,32000000,Drama,32701088,Dreamer: Inspired by a True Story,106,6.9,10608,701088
4377,16000000,Drama,1666262,The White Countess,135,6.7,5569,-14333738
4378,0,Biography,454711,Last Days,97,5.8,19666,454711
4379,1000000,Crime,44785,The Zodiac,97,5.4,6464,-955215
4380,0,Crime,56103,The Aura,134,7.3,11477,56103
4381,0,Drama,374903,Asylum,99,6.1,4365,374903
4382,35000000,Animation,19447478,Valiant,76,5.6,17195,-15552522
4383,3000000,Crime,2912363,Tsotsi,94,7.3,25853,-87637
4384,0,Drama,117581,Time to Leave,81,7.1,7609,117581
4385,6800000,Comedy,49526,The Chumscrubber,108,7.0,16769,-6750474
4386,0,Comedy,17378977,Roll Bounce,112,6.0,5848,17378977
4387,10000000,Comedy,12594698,The Matador,96,6.8,41498,2594698
4388,33000000,Action,8326035,The Man,83,5.5,22713,-24673965
4389,0,Crime,121390,13 Tzameti,93,7.4,15418,121390
4390,7500000,Action,143615,Man-Thing,105,4.0,5119,-7356385
4391,3500000,Comedy,101228,Winter Passing,100,6.4,7539,-3398772
4392,0,Action,370627,Shadowboxer,93,5.6,6165,370627
4393,2500000,Comedy,247141,Marilyn Hotchkiss' Ballroom Dancing & Charm School,100,6.6,2382,-2252859
4394,0,Biography,676167,Sophie Scholl: The Final Days,120,7.7,23519,676167
4395,0,Crime,1452402,Paradise Now,90,7.5,20477,1452402
4396,12500000,Comedy,323331,Russian Dolls,125,7.0,17470,-12176669
4397,0,Crime,651234,L'enfant,95,7.5,15410,651234
4398,0,Comedy,58116,Dirty Love,91,3.5,6228,58116
4399,500000,Drama,79943,The Death of Mr. Lazarescu,153,8.0,11161,-420057
4400,40000000,Drama,53089891,The Prestige,130,8.5,943597,13089891
4401,90000000,Crime,132384315,The Departed,151,8.5,962185,42384315
4402,0,Drama,37634615,Pan's Labyrinth,118,8.2,511652,37634615
4403,65000000,Action,210614939,300,117,7.7,648211,145614939
4404,225000000,Action,423315812,Pirates of the Caribbean: Dead Man's Chest,151,7.3,567704,198315812
4405,35000000,Drama,10144010,The Fountain,96,7.3,203187,-24855990
4406,76000000,Drama,35552383,Children of Men,109,7.9,391981,-40447617
4407,150000000,Action,167445960,Casino Royale,144,8.0,503887,17445960
4408,40000000,Action,50866635,Apocalypto,139,7.8,252584,10866635
4409,35000000,Comedy,124740460,The Devil Wears Prada,109,6.8,308388,89740460
4410,2000000,Drama,11286112,The Lives of Others,137,8.5,285724,9286112
4411,120000000,Animation,244082982,Cars,117,7.1,292006,124082982
4412,0,Adventure,438653,Idiocracy,84,6.6,118217,438653
4413,50000000,Adventure,46982632,Terror en Silent Hill,125,6.6,189068,-3017368
4414,55000000,Biography,163566459,The Pursuit of Happyness,117,8.0,369367,108566459
4415,8000000,Comedy,59891098,Little Miss Sunshine,101,7.8,381001,51891098
4416,0,Comedy,26870825,Pisando firme,103,6.4,23787,26870825
4417,700000,Drama,2694973,Half Nelson,106,7.2,75238,1994973
4418,15000000,Horror,41778863,The Hills Have Eyes,107,6.4,139041,26778863
4419,85000000,Comedy,63224849,The Holiday,138,6.9,197811,-21775151
4420,20000000,Comedy,2339735,She's the Man,105,6.4,125579,-17660265
4421,85000000,Action,62514415,The Fast and the Furious: Tokyo Drift,104,6.0,199003,-22485585
4422,125000000,Mystery,217536138,The Da Vinci Code,149,6.6,345008,92536138
4423,40000000,Biography,15962471,Marie Antoinette,123,6.4,85914,-24037529
4424,100000000,Adventure,57366262,Diamante de sangre,143,8.0,430028,-42633738
4425,0,Adventure,2280348,The Fall,117,7.9,94912,2280348
4426,35000000,Comedy,7458269,A Good Year,117,6.9,76333,-27541731
4427,0,Biography,15229325,Sospechas mortales,117,6.9,91466,15229325
4428,45000000,Crime,88513495,Inside Man,129,7.6,290361,43513495
4429,25000000,Drama,34302837,Babel,143,7.5,257380,9302837
4430,10000000,Horror,80238724,Saw III,108,6.2,152336,70238724
4431,16000000,Horror,39517763,The Texas Chainsaw Massacre: The Beginning,91,5.9,59869,23517763
4432,17000000,Action,35662731,Smokin' Aces,109,6.7,125910,18662731
4433,16000000,Drama,39868642,The Illusionist,110,7.6,316052,23868642
4434,24000000,Drama,70270943,Rocky Balboa,102,7.2,174575,46270943
4435,0,Crime,2223293,El Perfume: Historia de un asesino,147,7.5,202948,2223293
4436,210000000,Action,234362462,X-Men III: La batalla final,104,6.7,415430,24362462
4437,70000000,Comedy,137355633,Click,107,6.4,263834,67355633
4438,52000000,Comedy,118703275,The Break-Up,106,5.8,108341,66703275
4439,75000000,Action,64038616,Deja Vu,126,7.0,258182,-10961384
4440,0,Comedy,6088249,Grandma's Boy,94,7.0,70595,6088249
4441,12000000,Crime,65328121,Step Up,104,6.5,97712,53328121
4442,135000000,Action,63450470,Miami Vice,134,6.0,97434,-71549530
4443,209000000,Action,200081192,Superman Returns,154,6.1,249656,-8918808
4444,18000000,Comedy,41011711,John Tucker Must Die,89,5.8,71344,23011711
4445,72500000,Action,148213377,Talladega Nights: The Ballad of Ricky Bobby,108,6.6,140305,75713377
4446,150000000,Action,134029801,Mission: Impossible III,126,6.9,275630,-15970199
4447,18000000,Comedy,128505958,Borat: Cultural Learnings of America for Make Benefit Glorious Nation of Kazakhstan,84,7.3,312878,110505958
4448,0,Crime,327919,This Is England,101,7.7,104084,327919
4449,27000000,Crime,22494487,Lucky Number Slevin,110,7.8,275930,-4505513
4450,110000000,Adventure,250863268,Night at the Museum,108,6.4,257969,140863268
4451,75000000,Animation,73661010,Monster House,91,6.6,79512,-1338990
4452,20000000,Action,23292105,The Covenant,97,5.3,41469,3292105
4453,160000000,Action,60674817,Poseidon,98,5.6,86466,-99325183
4454,70000000,Drama,103365956,Dreamgirls,130,6.5,60034,33365956
4455,0,Action,2201923,The Host,120,7.0,76265,2201923
4456,23000000,Comedy,36323505,Accepted,93,6.5,110788,13323505
4457,15000000,Drama,9396870,Black Snake Moan,116,7.0,55548,-5603130
4458,70000000,Drama,5971336,Basic Instinct 2,114,4.2,32861,-64028664
4459,26000000,Drama,5463019,Little Children,136,7.6,96259,-20536981
4460,65000000,Adventure,71726025,RV,99,5.5,49145,6726025
4461,90000000,Drama,59952835,The Good Shepherd,167,6.7,90199,-30047165
4462,65000000,Drama,43545364,We Are Marshall,131,7.1,50115,-21454636
4463,100000000,Action,75030163,Eragon,104,5.1,112350,-24969837
4464,8700000,Animation,5501616,A Scanner Darkly,100,7.1,94464,-3198384
4465,21000000,Drama,4398392,Black Book,145,7.8,63950,-16601608
4466,0,Drama,751138,El imperio,180,7.0,45610,751138
4467,70000000,Drama,42285169,Lady in the Water,110,5.6,84057,-27714831
4468,2000000,Drama,1985292,Shortbus,101,6.5,28807,-14708
4469,0,Adventure,8319186,Tenacious D in The Pick of Destiny,93,6.8,90830,8319186
4470,19000000,Drama,13756082,Letters from Iwo Jima,141,7.9,139014,-5243918
4471,12000000,Action,27829874,Crank,88,7.0,208393,15829874
4472,19400000,Drama,8060487,Al otro lado del mundo,125,7.5,81655,-11339513
4473,38000000,Comedy,40137776,Stranger Than Fiction,113,7.6,196901,2137776
4474,63000000,Drama,70278893,World Trade Center,129,6.0,70654,7278893
4475,15500000,Comedy,7774730,Criaturas rastreras,95,6.5,65460,-7725270
4476,100000000,Animation,198000317,Happy Feet,108,6.5,144200,98000317
4477,40000000,Adventure,81612565,Eight Below,120,7.3,52356,41612565
4478,40000000,Drama,52330111,The Lake House,99,6.8,121026,12330111
4479,90000000,Drama,33602376,Flags of our Fathers,135,7.1,106291,-56397624
4480,80000000,Animation,155019340,Over the Hedge,83,6.8,136214,75019340
4481,6000000,Biography,17605861,The Last King of Scotland,123,7.7,154942,11605861
4482,50000000,Action,62318875,Underworld: Evolution,106,6.7,169745,12318875
4483,149000000,Animation,64665672,Flushed Away,85,6.6,92380,-84334328
4484,25000000,Horror,54098051,Destino final 3,93,5.8,110532,29098051
4485,15000000,Drama,31567134,United 93,111,7.6,87699,16567134
4486,30000000,Action,18500966,Ultraviolet,88,4.4,73282,-11499034
4487,10000000,Adventure,5490423,Rescue Dawn,120,7.3,89482,-4509577
4488,0,Comedy,24942,Cashback,102,7.2,76132,24942
4489,0,Crime,6177192,Tell No One,131,7.6,41947,6177192
4490,32000000,Comedy,80197993,Nacho Libre,92,5.7,69721,48197993
4491,15000000,Crime,17508670,Notes on a Scandal,92,7.4,67309,2508670
4492,0,Biography,56441711,The Queen,103,7.3,91427,56441711
4493,33000000,Action,34020814,Serpientes a bordo,105,5.6,120282,1020814
4494,40000000,Biography,57789574,Invincible,105,7.1,55713,17789574
4495,12000000,Comedy,18595716,Aquamarine,100,5.3,33023,6595716
4496,0,Animation,881302,Paprika,90,7.7,51679,881302
4497,40000000,Horror,23643531,The Wicker Man,102,3.7,56253,-16356469
4498,20000000,Action,18843314,The Marine,92,4.7,28911,-1156686
4499,17500000,Comedy,19185184,Beerfest,110,6.3,57005,1685184
4500,50000000,Crime,22518325,La Dalia Negra,121,5.6,65604,-27481675
4501,25000000,Horror,54607383,The Omen,110,5.5,50944,29607383
4502,4000000,Drama,7006708,Bug,102,6.1,29353,3006708
4503,28000000,Comedy,17324744,Just My Luck,100,5.4,47270,-10675256
4504,33000000,Action,57651794,The Benchwarmers,80,5.6,42905,24651794
4505,45000000,Comedy,90710620,Scary Movie 4,83,5.1,99473,45710620
4506,50000000,Comedy,88715192,Failure to Launch,97,5.6,62338,38715192
4507,4000000,Comedy,10525717,Scoop,96,6.7,71751,6525717
4508,10000000,Horror,7025803,Turistas,93,5.3,32558,-2974197
4509,21000000,Action,480314,DOA: Dead or Alive,87,4.8,39969,-20519686
4510,70000000,Action,55011732,The Guardian,139,6.9,78977,-14988268
4511,0,Comedy,2197331,Rang De Basanti,157,8.3,84309,2197331
4512,0,Comedy,12899867,Volver,121,7.6,81978,12899867
4513,15000000,Horror,47860214,When a Stranger Calls,87,5.1,37253,32860214
4514,65000000,Adventure,82226474,The Pink Panther,93,5.6,70105,17226474
4515,10000000,Drama,3960414,Peaceful Warrior,100,7.3,22445,-6039586
4516,1000000,Comedy,316996,Wristcutters: A Love Story,88,7.4,48536,-683004
4517,35000000,Action,11631245,Zoom,100,4.3,16115,-23368755
4518,0,Comedy,136432,Severance,96,6.5,33173,136432
4519,0,Comedy,82985708,Charlotte's Web,97,6.3,30383,82985708
4520,15000000,Comedy,10011274,Penelope,104,6.8,53683,-4988726
4521,0,Drama,14732623,Tristan + Isolde,100,6.9,46906,14732623
4522,55000000,Drama,7221458,All the King's Men,128,6.2,21583,-47778542
4523,20000000,Comedy,48548426,Date Movie,83,2.7,52303,28548426
4524,13000000,Comedy,4857376,"Paris, je t'aime",120,7.3,65342,-8142624
4525,80000000,Animation,195330621,Ice Age: The Meltdown,91,6.9,211943,115330621
4526,0,Comedy,21160089,ATL,105,6.0,8872,21160089
4527,5000000,Comedy,24138847,Clerks II,97,7.4,119342,19138847
4528,64000000,Comedy,58645052,Littleman,100,4.3,42365,-5354948
4529,0,Comedy,15269668,Catch and Release,112,6.0,19855,15269668
4530,17000000,Action,6855137,Running Scared,122,7.4,91057,-10144863
4531,0,Drama,44720,Candy,108,7.3,38145,44720
4532,17000000,Comedy,275380,Southland Tales,145,5.5,33669,-16724620
4533,40000000,Action,652526,Alex Rider: Operation Stormbreaker,93,5.1,21238,-39347474
4534,0,Drama,22490,The Exterminating Angels,100,5.5,2583,22490
4535,20000000,Horror,20259297,Pulse,90,4.7,25920,259297
4536,0,Action,24623719,Fearless,104,7.7,65534,24623719
4537,30000000,Comedy,22530295,My Super Ex-Girlfriend,96,5.1,56128,-7469705
4538,28000000,Biography,14415222,Hollywoodland,126,6.5,30288,-13584778
4539,30000000,Crime,38432823,Gridiron Gang,125,6.9,35771,8432823
4540,86000000,Animation,15132763,Arthur and the Invisibles,94,6.0,27672,-70867237
4541,9000000,Horror,23086480,Stay Alive,85,5.1,26907,14086480
4542,0,Comedy,2706659,The History Boys,109,6.9,18566,2706659
4543,0,Comedy,82987,Black Sheep,87,5.8,36120,82987
4544,85000000,Animation,85105259,Open Season,86,6.2,71052,105259
4545,0,Comedy,210128,Starter for 10,92,6.7,19040,210128
4546,1500000,Comedy,155873,Hatchet,84,5.7,24641,-1344127
4547,0,Drama,1829142,The Wind That Shakes the Barley,127,7.5,39412,1829142
4548,0,Biography,21208358,Amazing Grace,118,7.5,21869,21208358
4549,9000000,Horror,16235293,Black Christmas,84,4.6,21102,7235293
4550,18000000,Crime,188565,Amores asesinos,108,6.5,18418,-17811435
4551,52000000,Action,36883539,16 Blocks,102,6.6,116840,-15116461
4552,0,Biography,42643187,Glory Road,118,7.2,37118,42643187
4553,50000000,Crime,48751189,Firewall,105,5.8,51779,-1248811
4554,54000000,Comedy,75628110,"You, Me and Dupree",110,5.6,71458,21628110
4555,60000000,Action,13082288,Flyboys,140,6.6,37329,-46917712
4556,20000000,Horror,39143839,The Grudge 2,102,5.0,41311,19143839
4557,60000000,Action,36280697,The Sentinel,108,6.1,43940,-23719303
4558,1000000,Drama,1100000,Loving Annabelle,76,6.6,10025,100000
4559,35000000,Animation,14522427,Everyone's Hero,87,5.8,6650,-20477573
4560,45000000,Action,6566773,Curse of the Golden Flower,100,7.0,38097,-38433227
4561,100000,Drama,10178331,Facing the Giants,111,6.7,13291,10078331
4562,12000000,Comedy,6754898,Running with Scissors,122,6.2,20590,-5245102
4563,50000000,Animation,58640119,Curious George,87,6.6,13503,8640119
4564,30000000,Drama,34742066,Take the Lead,118,6.7,22722,4742066
4565,40000000,Comedy,70165972,Big Momma's House 2,99,4.6,34616,30165972
4566,12000000,Adventure,84500122,The Santa Clause 3: The Escape Clause,97,4.7,24317,72500122
4567,14000000,Biography,11242801,Bobby,117,7.0,39109,-2757199
4568,30000000,Biography,2975649,Miss Potter,88,7.0,25132,-27024351
4569,7000000,Biography,1661464,Factory Girl,99,6.4,19204,-5338536
4570,0,Drama,412544,Después de la boda,120,7.8,27574,412544
4571,6000000,Comedy,63257940,Madea's Family Reunion,107,5.1,9376,57257940
4572,0,Animation,48461,Cuentos de Terramar,115,6.5,26067,48461
4573,8000000,Action,15032800,See No Evil,84,5.1,23111,7032800
4574,50000000,Biography,1000045,Goya's Ghosts,113,6.9,26348,-48999955
4575,51000000,Animation,72779000,La Granja,100,5.6,22732,21779000
4576,16800000,Biography,220914,Fur: An Imaginary Portrait of Diane Arbus,122,6.5,13848,-16579086
4577,0,Comedy,4261350,Van Wilder 2: The Rise of Taj,97,4.8,20196,4261350
4578,13000000,Biography,1173673,Find Me Guilty,125,7.1,29604,-11826327
4579,0,Drama,18569,The Unknown Woman,118,7.5,10774,18569
4580,20000000,Comedy,17803796,School for Scoundrels,100,5.9,27180,-2196204
4581,12000000,Comedy,28435406,Employee of the Month,103,5.5,39328,16435406
4582,0,Comedy,11425894,Something New,99,6.8,11116,11425894
4583,500000,Comedy,654132,Another Gay Movie,92,5.0,8093,154132
4584,6500000,Comedy,13367101,Friends with Money,88,5.8,21023,6867101
4585,0,Drama,3438735,The Ultimate Gift,100,7.4,15148,3438735
4586,6000000,Comedy,4663809,The Science of Sleep,105,7.3,63643,-1336191
4587,60000000,Animation,28426747,Garfield 2,82,5.0,30758,-31573253
4588,0,Comedy,10205,Taxidermia,91,7.0,14123,10205
4589,20000000,Comedy,11596143,The Last Kiss,115,6.5,38919,-8403857
4590,3700000,Crime,144397,Unknown,85,6.5,27012,-3555603
4591,0,Drama,8661334,The Namesake,122,7.6,17331,8661334
4592,50000000,Animation,28142535,The Ant Bully,88,5.9,31986,-21857465
4593,20000000,Biography,13395961,One Night with the King,123,6.3,6072,-6604039
4594,0,Drama,18811135,Akeelah and the Bee,100,7.5,16244,18811135
4595,17000000,Comedy,7191830,American Dreamz,107,5.5,23173,-9808170
4596,45000000,Comedy,38360195,Last Holiday,112,6.4,23013,-6639805
4597,80000000,Animation,37384046,Vida salvaje,100,5.3,20301,-42615954
4598,0,Comedy,69136,Behind the Mask: The Rise of Leslie Vernon,100,6.8,18107,69136
4599,0,Crime,516139,A Guide to Recognizing Your Saints,100,7.0,23014,516139
4600,0,Comedy,1499127,Priceless,106,7.0,27386,1499127
4601,0,Comedy,1004059,Fast Food Nation,114,6.3,21699,1004059
4602,13000000,Biography,1150403,Infamous,110,7.1,14841,-11849597
4603,26000000,Drama,17127992,Annapolis,108,5.8,18618,-8872008
4604,0,Drama,4571521,Lejos de ella,110,7.6,19642,4571521
4605,13000000,Adventure,10996440,The Astronaut Farmer,104,6.3,20587,-2003560
4606,0,Action,1018965,Hombre lobo,110,4.6,12056,1018965
4607,20000000,Comedy,37442180,Man of the Year,115,6.2,29068,17442180
4608,18000000,Action,418296,Seraphim Falls,115,6.7,25950,-17581704
4609,0,Comedy,233637,The Foot Fist Way,82,6.4,9799,233637
4610,500000,Comedy,23000,Poultrygeist: Night of the Chicken Dead,103,6.2,6500,-477000
4611,0,Comedy,4613815,Let's Go to Prison,84,6.0,20852,4613815
4612,0,Crime,928960,Breaking and Entering,120,6.5,20590,928960
4613,32000000,Drama,1308696,The Good German,105,6.1,22267,-30691304
4614,0,Crime,17311,The Dead Girl,93,6.7,12988,17311
4615,15000000,Adventure,20998709,Flicka,95,6.2,6494,5998709
4616,0,Comedy,87416,Blind Dating,100,6.1,10385,87416
4617,26000000,Adventure,16647384,Unaccompanied Minors,90,5.1,8970,-9352616
4618,8000000,Comedy,298110,Mi mascota es un zombie,93,6.7,26072,-7701890
4619,0,Comedy,35092918,Deck the Halls,93,4.9,17377,35092918
4620,150000000,Action,319071806,Transformers,144,7.1,541000,169071806
4621,25000000,Crime,74283625,No Country for Old Men,122,8.1,679346,49283625
4622,65000000,Crime,33080084,Zodiac,157,7.7,343160,-31919916
4623,70000000,Adventure,38634938,Stardust,127,7.7,224119,-31365062
4624,150000000,Adventure,292004738,Harry Potter and the Order of the Phoenix,138,7.5,396738,142004738
4625,61000000,Action,47003582,Shooter,124,7.2,273032,-13996418
4626,0,Action,23637265,Hot Fuzz,121,7.9,385466,23637265
4627,25000000,Drama,40222514,There Will Be Blood,158,8.1,412459,15222514
4628,15000000,Adventure,18352454,Into the Wild,148,8.1,471946,3352454
4629,18000000,Horror,25593755,The Mist,126,7.2,239527,7593755
4630,19000000,Crime,20300218,Gone Baby Gone,114,7.7,212956,1300218
4631,300000000,Action,309420425,Pirates of the Caribbean: At World's End,169,7.1,514191,9420425
4632,20000000,Comedy,121463226,Superbad,113,7.6,450691,101463226
4633,150000000,Drama,256386216,I Am Legend,101,7.2,579646,106386216
4634,30000000,Drama,31655091,August Rush,114,7.5,92924,1655091
4635,0,Crime,39015018,Fracture,113,7.2,152773,39015018
4636,30000000,Drama,50927067,Atonement,123,7.8,207447,20927067
4637,258000000,Action,336530303,Spider-Man 3,139,6.2,416842,78530303
4638,15000000,Horror,58272029,Halloween,109,6.1,93548,43272029
4639,75000000,Comedy,118871849,Hairspray,117,6.7,104717,43871849
4640,150000000,Animation,206445654,Ratatouille,111,8.0,516560,56445654
4641,30000000,Biography,3904982,The Assassination of Jesse James by the Coward Robert Ford,160,7.5,146553,-26095018
4642,0,Adventure,3675753,Sunshine,107,7.3,204114,3675753
4643,7500000,Comedy,143495265,Juno,96,7.5,439421,135995265
4644,15000000,Crime,1294640,Funny Games,111,6.5,75924,-13705360
4645,85000000,Animation,127807262,Enchanted,107,7.1,153161,42807262
4646,180000000,Adventure,70107728,The Golden Compass,113,6.1,157342,-109892272
4647,100000000,Biography,130164645,American Gangster,157,7.8,342994,30164645
4648,50000000,Drama,52898073,Sweeney Todd: The Demon Barber of Fleet Street,116,7.4,301732,2898073
4649,110000000,Action,227471070,The Bourne Ultimatum,115,8.1,537243,117471070
4650,150000000,Animation,82161969,Beowulf,115,6.2,148203,-67838031
4651,15000000,Drama,28638916,28 Weeks Later,100,7.0,225731,13638916
4652,30000000,Drama,53695808,P.S. I Love You,126,7.1,180134,23695808
4653,25000000,Horror,71985628,1408,104,6.8,226504,46985628
4654,30000000,Comedy,148734225,Knocked Up,129,7.0,313748,118734225
4655,0,Crime,17114882,Eastern Promises,100,7.7,201552,17114882
4656,24000000,Action,39687694,Hitman - Agente 47,100,6.3,146777,15687694
4657,110000000,Action,134529403,Live Free or Die Hard,128,7.2,352297,24529403
4658,45000000,Drama,24343673,Across the Universe,133,7.4,96537,-20656327
4659,53000000,Action,25031037,Grindhouse,191,7.6,162394,-27968963
4660,17000000,Adventure,82272442,Bridge to Terabithia,96,7.2,119947,65272442
4661,110000000,Action,115802596,Ghost Rider,114,5.2,194164,5802596
4662,17500000,Adventure,11902715,The Darjeeling Limited,91,7.2,149906,-5597285
4663,10000000,Horror,17609452,Hostel: Part II,94,5.5,74531,7609452
4664,20000000,Drama,80209692,Disturbia,105,6.9,196330,60209692
4665,32000000,Mystery,35193167,The Number 23,101,6.4,174137,3193167
4666,10000000,Comedy,1959420,Margot at the Wedding,93,6.1,16620,-8040580
4667,140000000,Action,140125968,Rush Hour 3,91,6.2,130138,125968
4668,0,Drama,40677,The Babysitters,88,5.7,9225,40677
4669,55000000,Adventure,53606916,3:10 to Yuma,122,7.7,252471,-1393084
4670,160000000,Animation,320706665,Shrek the Third,93,6.1,230142,160706665
4671,175000000,Comedy,100462298,Evan Almighty,96,5.4,121468,-74537702
4672,0,Drama,7161284,The Orphanage,105,7.5,128109,7161284
4673,12000000,Comedy,5972884,Lars and the Real Girl,106,7.4,122310,-6027116
4674,40000000,Action,41797066,Aliens vs. Predator: Requiem,94,4.7,100087,1797066
4675,20000000,Horror,16809076,Dead Silence,89,6.2,73126,-3190924
4676,32000000,Horror,39568996,30 Days of Night,113,6.6,146606,7568996
4677,10000000,Horror,63300095,Saw IV,93,5.9,119307,53300095
4678,85000000,Crime,117154724,Ocean's Thirteen,122,6.9,274708,32154724
4679,150000000,Animation,126631277,Bee Movie,91,6.1,115409,-23368723
4680,21000000,Biography,36605602,Escritores de la libertad,123,7.5,56827,15605602
4681,45000000,Adventure,93466502,The Bucket List,97,7.4,198697,48466502
4682,60000000,Comedy,36787257,The Heartbreak Kid,116,5.8,75859,-23212743
4683,15000,Horror,107918810,Paranormal Activity,86,6.3,195668,107903810
4684,20000000,Crime,28476219,Mr. Brooks,120,7.3,129919,8476219
4685,75000000,Animation,183135014,The Simpsons Movie,87,7.4,273363,108135014
4686,75000000,Biography,66661095,Charlie Wilson's War,102,7.1,94070,-8338905
4687,50000000,Crime,27670986,Hannibal Rising,121,6.2,91666,-22329014
4688,0,Biography,10301706,La Vie en Rose,140,7.6,71319,10301706
4689,22000000,Comedy,90648202,The Game Plan,110,6.2,48000,68648202
4690,85000000,Comedy,120059556,I Now Pronounce You Chuck & Larry,115,6.0,126092,35059556
4691,45000000,Action,50648679,Resident Evil: Extinction,94,6.3,162711,5648679
4692,130000000,Action,131921738,Fantastic 4: Rise of the Silver Surfer,92,5.6,223740,1921738
4693,70000000,Action,18211013,Next,96,6.2,131848,-51788987
4694,25000000,Comedy,47642963,Dan in Real Life,98,6.8,89881,22642963
4695,9000000,Comedy,8579684,Death at a Funeral,87,7.4,95249,-420316
4696,39000000,Action,12807139,Shoot 'Em Up,86,6.7,134902,-26192861
4697,130000000,Action,219964115,National Treasure: Book of Secrets,124,6.5,193052,89964115
4698,0,Comedy,13920741,Hot Rod,100,6.7,64550,13920741
4699,25000000,Comedy,34925283,Good Luck Chuck,101,5.6,77598,9925283
4700,25000000,Crime,49033882,Michael Clayton,119,7.3,140798,24033882
4701,0,Drama,9439923,Once,85,7.9,98719,9439923
4702,61000000,Comedy,118594548,Blades of Glory,100,6.3,137537,57594548
4703,35000000,Action,5932060,The Last Legion,102,5.4,30987,-29067940
4704,60000000,Comedy,95673607,Norbit,100,4.0,56668,35673607
4705,20000000,Biography,4017609,Mi historia sin mi,135,7.0,50599,-15982391
4706,150000000,Animation,97822171,Meet the Robinsons,95,6.9,72807,-52177829
4707,20000000,Action,9525276,Death Sentence,105,6.8,62804,-10474724
4708,25000000,Comedy,33302167,Mr. Bean's Holiday,90,6.3,96177,8302167
4709,0,Comedy,347578,Teeth,94,5.4,36169,347578
4710,4000000,Action,8060,Elite Squad,115,8.1,86772,-3991940
4711,0,Action,168273550,Wild Hogs,100,5.9,104256,168273550
4712,60000000,Animation,217326974,Alvin and the Chipmunks,92,5.2,62132,157326974
4713,20000000,Comedy,10005534,Bratz,100,2.9,15573,-9994466
4714,20000000,Adventure,39739367,Epic Movie,86,2.3,93481,19739367
4715,15000000,Action,20804166,The Hills Have Eyes II,89,5.1,53021,5804166
4716,80000000,Sci-Fi,15071514,The Invasion,99,5.9,67939,-64928486
4717,18000000,Crime,7083025,Before the Devil Knows You're Dead,117,7.3,85707,-10916975
4718,40000000,Comedy,50572589,Music and Lyrics,95,6.5,86258,10572589
4719,55000000,Biography,16285240,Elizabeth: The Golden Age,114,6.9,58073,-38714760
4720,8600000,Crime,14377198,Awake,84,6.5,66246,5777198
4721,35000000,Comedy,18317151,Walk Hard: The Dewey Cox Story,96,6.7,58230,-16682849
4722,2600000,Horror,38108,Rewind,92,7.2,46642,-2561892
4723,70000000,Action,47536778,The Kingdom,110,7.1,106339,-22463222
4724,20000000,Drama,19661987,Reign Over Me,124,7.5,86887,-338013
4725,10000000,Horror,16472961,The Hitcher,84,5.6,36616,6472961
4726,0,Drama,142666,Shelter,97,7.8,17462,142666
4727,35000000,Drama,14998070,Lions for Lambs,92,6.2,42926,-20001930
4728,19000000,Horror,19363565,Vacancy,85,6.2,84066,363565
4729,20000000,Drama,15800078,The Kite Runner,128,7.6,71096,-4199922
4730,1500000,Comedy,19067631,Waitress,108,7.0,39286,17567631
4731,27500000,Drama,9736045,Rendition,122,6.8,49635,-17763955
4732,60795000,Crime,23984949,Perfect Stranger,109,5.7,39651,-36810051
4733,21000000,Crime,28563179,We Own the Night,117,6.9,75706,7563179
4734,30000000,Crime,16930884,88 Minutes,108,5.9,68510,-13069116
4735,0,Drama,1204660,Like Stars on Earth,165,8.5,109807,1204660
4736,0,Comedy,42674040,Because I Said So,100,5.6,33901,42674040
4737,0,Comedy,32844290,Balls of Fury,90,5.3,37238,32844290
4738,16500000,Biography,18670946,Becoming Jane,120,7.1,50326,2170946
4739,20000000,Drama,47852604,Premonition,96,5.9,65327,27852604
4740,0,Action,10452,Rogue,99,6.2,23320,10452
4741,0,Biography,871577,Control,122,7.7,54367,871577
4742,5000000,Drama,244397,Youth Without Youth,124,6.3,11873,-4755603
4743,0,Biography,5990075,The Diving Bell and the Butterfly,112,8.0,94015,5990075
4744,100000000,Animation,58867694,Surf's Up,85,6.7,57904,-41132306
4745,25000000,Action,22466994,War,103,6.3,76529,-2533006
4746,70000000,Crime,36793804,The Brave One,122,6.8,52932,-33206196
4747,20000000,Comedy,25925170,The Nanny Diaries,106,6.2,51024,5925170
4748,30000000,Crime,20568319,The Invisible,102,6.3,32253,-9431681
4749,34000000,Animation,54149098,TMNT: Las Tortugas Ninja,87,6.3,55759,20149098
4750,0,Biography,33231264,Breach,110,7.0,53763,33231264
4751,12000000,Mystery,7498716,I Know Who Killed Me,100,3.6,23832,-4501284
4752,4600000,Drama,434417,Savage Grace,97,5.9,9518,-4165583
4753,20000000,Action,10232081,Pathfinder,99,5.4,38839,-9767919
4754,22000000,Comedy,25628629,Mr. Woodcock,100,5.2,32229,3628629
4755,27000000,Comedy,7486906,Martian Child,106,6.8,18187,-19513094
4756,28000000,Comedy,43107979,No Reservations,104,6.3,62276,15107979
4757,0,Action,3718,The Condemned,100,6.1,46635,3718
4758,16500000,Comedy,11892415,Sydney White,108,6.3,40178,-4607585
4759,20000000,Comedy,25612520,Nancy Drew,99,5.9,16948,5612520
4760,60000000,Action,4535117,In the Name of the King: A Dungeon Siege Tale,127,3.8,39999,-55464883
4761,45000000,Drama,4607608,Love in the Time of Cholera,139,6.4,20111,-40392392
4762,7300000,Animation,4443403,Persépolis,96,8.1,75802,-2856597
4763,40000000,Horror,25117498,The Reaping,99,5.7,38837,-14882502
4764,0,Crime,6777741,In the Valley of Elah,121,7.2,62833,6777741
4765,10000000,Comedy,11043445,In the Land of Women,97,6.5,28844,1043445
4766,15000000,Biography,30226144,The Great Debaters,126,7.6,50295,15226144
4767,10000000,Drama,866778,Noches púrpuras,95,6.7,46741,-9133222
4768,0,Biography,55704,El asesino de John Lennon,84,5.7,9163,55704
4769,5000000,Comedy,23563,Sex and Death 101,117,6.0,9860,-4976437
4770,17000000,Crime,2626800,Captivity,96,4.7,21178,-14373200
4771,8000000,Crime,3992339,P2,98,5.9,27335,-4007661
4772,65000000,Comedy,32061555,Mr. Magorium's Wonder Emporium,93,6.2,37538,-32938445
4773,20000000,Drama,1103075,Retrato de amor,107,5.9,9922,-18896925
4774,0,Comedy,3573870,The Jane Austen Book Club,106,6.8,22821,3573870
4775,12000000,Crime,214202,Crimen sin perdón,120,7.4,15474,-11785798
4776,0,Comedy,5998971,"Run, Fatboy, Run",100,6.6,60897,5998971
4777,6000000,Drama,20146,Wind Chill,91,5.9,18857,-5979854
4778,2000000,Horror,958961,Diary of the Dead,95,5.7,42332,-1041039
4779,0,Action,1784769,Son of Rambow,96,7.0,28319,1784769
4780,16000000,Horror,35374833,The Messengers,90,5.4,35022,19374833
4781,35000000,Comedy,43799818,License to Wed,91,5.3,33769,8799818
4782,0,Comedy,221846,Eagle vs Shark,93,6.8,18012,221846
4783,12000000,Comedy,3950294,Charlie Bartlett,97,7.0,58595,-8049706
4784,15000000,Drama,4602512,"Lust, Caution",157,7.6,32328,-10397488
4785,0,Drama,342835,Sleuth,88,6.5,27338,342835
4786,0,Drama,9422422,The Visitor,104,7.7,38726,9422422
4787,40000000,Adventure,40412817,Mi mascota es un monstruo,112,6.5,33637,412817
4788,0,Drama,1185783,"4 Months, 3 Weeks and 2 Days",113,7.9,48360,1185783
4789,16000000,Crime,4600585,The Lookout,99,7.1,52730,-11399415
4790,0,Action,43751706,Underdog,100,4.8,16782,43751706
4791,14000000,Drama,61356221,Stomp the Yard,100,5.3,20221,47356221
4792,0,Crime,5484715,The Counterfeiters,98,7.6,38547,5484715
4793,0,Action,18005198,Postal,100,4.5,20748,18005198
4794,0,Drama,402820,Snow Angels,107,6.9,11384,402820
4795,20000000,Comedy,18882880,Georgia Rule,100,5.9,21482,-1117120
4796,100000000,Comedy,72006777,Fred Claus,116,5.6,33861,-27993223
4797,0,Crime,971561,Cassandra's Dream,108,6.7,46067,971561
4798,10000000,Drama,31339647,Daddy's Little Girls,100,5.5,6254,21339647
4799,0,Drama,62745,The Nines,100,6.4,30052,62745
4800,0,Drama,21471047,The Last Mimzy,96,6.3,19523,21471047
4801,0,Drama,3504875,Feast of Love,97,6.7,14779,3504875
4802,0,Comedy,6610326,The Savages,114,7.2,33132,6610326
4803,3800000,Action,48034,Sukiyaki Western Django,121,6.3,13379,-3751966
4804,28000000,Comedy,49631958,Are We Done Yet?,92,4.0,16749,21631958
4805,0,Action,10597734,Primeval,93,4.7,11611,10597734
4806,16000000,Drama,3287315,Things We Lost in the Fire,118,7.2,25351,-12712685
4807,25000000,Adventure,969869,The Hunting Party,101,6.9,22857,-24030131
4808,20000000,Adventure,5701643,Mongol: The Rise of Genghis Khan,126,7.3,39640,-14298357
4809,16000000,Biography,9176787,A Mighty Heart,108,6.7,24917,-6823213
4810,20000000,Comedy,13349251,The Comebacks,107,4.2,10302,-6650749
4811,20000000,Crime,1200234,Flawless,108,6.8,20482,-18799766
4812,0,Drama,46011,XXY,86,7.1,11279,46011
4813,0,Drama,371446,Towelhead,116,7.0,10669,371446
4814,11000000,Crime,121994,Reservation Road,102,6.7,19672,-10878006
4815,0,Biography,4472823,Talk to Me,118,7.4,8730,4472823
4816,0,Drama,106368,Boy A,102,7.7,34409,106368
4817,3750000,Drama,128092,Hounddog,100,6.3,5408,-3621908
4818,0,Comedy,9397,Smiley Face,85,5.8,14615,9397
4819,2600000,Horror,50000,Timber Falls,100,5.3,5236,-2550000
4820,15000000,Comedy,55184721,Why Did I Get Married?,100,5.7,10288,40184721
4821,13000000,Comedy,49121934,This Christmas,100,6.2,7027,36121934
4822,15000000,Drama,3525161,Blood and Chocolate,100,5.5,15964,-11474839
4823,3500000,Comedy,3735303,Then She Found Me,100,6.0,8895,235303
4824,8000000,Action,223537,Battle in Seattle,99,6.7,13248,-7776463
4825,4000000,Drama,46474,Un verano para toda la vida,105,6.6,10900,-3953526
4826,3500000,Horror,58669,Mother of Tears,102,5.1,7679,-3441331
4827,10000000,Crime,25775,The Air I Breathe,95,6.9,32130,-9974225
4828,0,Drama,13361,Descent,104,4.8,2682,13361
4829,0,Drama,12406646,Evening,117,6.6,12115,12406646
4830,35000000,Action,10977721,Dragon Wars: D-War,107,3.6,22050,-24022279
4831,6000000,Comedy,712391,Rocket Science,101,6.7,12086,-5287609
4832,0,Comedy,12550605,I Think I Love My Wife,94,5.5,14233,12550605
4833,0,Adventure,12589108,Under the Same Moon,106,7.4,5838,12589108
4834,26000000,Action,6877133,Redline,100,4.0,8133,-19122867
4835,45000000,Adventure,8791738,The Seeker: The Dark Is Rising,99,4.8,13682,-36208262
4836,10000000,Comedy,20342161,Reno 911!: Miami,100,5.9,24543,10342161
4837,0,Comedy,1849,Alucinaciones,84,4.7,14453,1849
4838,0,Comedy,4432981,2 Days in Paris,96,6.8,27948,4432981
4839,55000000,Drama,5755286,Lucky You,124,5.9,18870,-49244714
4840,185000000,Action,534858444,The Dark Knight,152,9.0,1839571,349858444
4841,37000000,Drama,191465414,Twilight,122,5.2,366772,154465414
4842,85000000,Action,75754670,Hellboy II: The Golden Army,120,7.0,221241,-9245330
4843,25000000,Comedy,48237389,The House Bunny,97,5.5,68405,23237389
4844,52000000,Comedy,144130063,Mamma Mia!,108,6.4,157292,92130063
4845,10000000,Horror,52597610,The Strangers,86,6.2,98780,42597610
4846,92000000,Action,110515313,Tropic Thunder,107,7.0,327846,18515313
4847,140000000,Action,318412101,Iron Man,126,7.9,755866,178412101
4848,25000000,Action,145000989,Búsqueda implacable,93,7.8,509623,120000989
4849,150000000,Drama,127509326,The Curious Case of Benjamin Button,166,7.8,495968,-22490674
4850,18000000,Action,5694401,RocknRolla,114,7.3,207016,-12305599
4851,6000000,Drama,26236603,The Wrestler,109,7.9,263945,20236603
4852,75000000,Action,134508551,Wanted,110,6.7,317547,59508551
4853,15000000,Drama,141319928,Slumdog Millionaire,120,8.0,690202,126319928
4854,180000000,Animation,223808164,WALL·E,98,8.4,799707,43808164
4855,150000000,Action,134518390,The Incredible Hulk,112,6.8,350423,-15481610
4856,65000000,Comedy,152647258,Sex and the City,145,5.5,104063,87647258
4857,0,Horror,5824,Eden Lake,91,6.8,63256,5824
4858,15000000,Comedy,7757130,In Bruges,107,7.9,328223,-7242870
4859,65000000,Comedy,100468793,Step Brothers,98,6.9,227558,35468793
4860,33000000,Drama,148095302,Gran Torino,116,8.2,609483,115095302
4861,35000000,Crime,81159365,21,123,6.8,201705,46159365
4862,12500000,Drama,9030581,The Boy in the Striped Pajamas,94,7.8,149511,-3469419
4863,0,Action,104792,Bronson,92,7.1,97452,104792
4864,200000000,Action,168368427,Quantum of Solace,106,6.6,353784,-31631573
4865,30000000,Comedy,63172463,Forgetting Sarah Marshall,111,7.2,230079,33172463
4866,15000000,Drama,17017811,The Hurt Locker,131,7.6,359240,2017811
4867,25000000,Action,80048433,Cloverfield,85,7.0,319809,55048433
4868,27000000,Action,87341380,Pineapple Express,111,7.0,272938,60341380
4869,30000000,Comedy,76808654,27 Dresses,111,6.1,133431,46808654
4870,185000000,Action,317101119,Indiana Jones and the Kingdom of the Crystal Skull,122,6.2,358563,132101119
4871,15500000,Drama,23216709,Vicky Cristina Barcelona,96,7.1,212733,7716709
4872,35000000,Drama,22911480,Revolutionary Road,119,7.3,162463,-12088520
4873,35000000,Action,7948159,Punisher: War Zone,103,6.0,52479,-27051841
4874,145000000,Action,102491776,The Mummy: Tomb of the Dragon Emperor,112,5.2,128515,-42508224
4875,0,Comedy,2656324,Easy Virtue,97,6.7,17579,2656324
4876,150000000,Action,227946274,Hancock,92,6.4,375055,77946274
4877,70000000,Action,39394666,Body of Lies,128,7.1,185521,-30605334
4878,130000000,Animation,215434591,Kung Fu Panda,92,7.6,339024,85434591
4879,90000000,Adventure,71195053,The Spiderwick Chronicles,96,6.6,74370,-18804947
4880,24000000,Comedy,31457946,Zack and Miri Make a Porno,101,6.6,156855,7457946
4881,48000000,Comedy,64506874,The Happening,91,5.0,173949,16506874
4882,75000000,Drama,83077833,Valkyrie,121,7.1,197529,8077833
4883,32000000,Drama,34194407,The Reader,124,7.6,202175,2194407
4884,225000000,Action,141621490,The Chronicles of Narnia: Prince Caspian,150,6.6,162829,-83378510
4885,50000000,Action,42754105,Rambo 4: Regreso al Infierno,92,7.0,189986,-7245895
4886,70000000,Action,70231041,Fool's Gold,112,5.7,64098,231041
4887,80000000,Action,130319208,Get Smart,110,6.5,176842,50319208
4888,55000000,Drama,69951824,Seven Pounds,123,7.7,249856,14951824
4889,28000000,Comedy,67294270,Un par nada ejemplar,99,6.9,202096,39294270
4890,85000000,Action,80172128,Jumper,88,6.1,256451,-4827872
4891,4000000,Drama,2122065,Let the Right One In,115,7.9,183463,-1877935
4892,20000000,Action,24850922,Never Back Down,110,6.6,85496,4850922
4893,35000000,Biography,26814957,The Other Boleyn Girl,115,6.7,89728,-8185043
4894,30000000,Action,10955425,Doomsday,113,6.0,65516,-19044575
4895,37000000,Comedy,60355347,Burn After Reading,96,7.0,264758,23355347
4896,50000000,Action,160641,Outlander,115,6.3,66198,-49839359
4897,0,Comedy,31973840,"Definitely, Maybe",112,7.2,135220,31973840
4898,90000000,Action,100018837,You Don't Mess with the Zohan,113,5.5,166095,10018837
4899,55000000,Biography,35739802,Changeling,141,7.8,209863,-19260198
4900,20000000,Crime,30028592,The Bank Job,111,7.3,158842,10028592
4901,35000000,Action,40689393,Max Payne,100,5.4,112236,5689393
4902,45000000,Action,101704370,Journey to the Center of the Earth,93,5.8,93923,56704370
4903,19000000,Adventure,8402485,Sex Drive,109,6.5,75976,-10597515
4904,40000000,Comedy,46012734,Made of Honor,101,5.9,58284,6012734
4905,45000000,Action,36316032,Death Race,105,6.4,176350,-8683968
4906,70000000,Comedy,97690976,Yes Man,104,6.8,289261,27690976
4907,20000000,Comedy,19780,Wild Child,98,6.1,40439,-19980220
4908,150000000,Animation,114053579,Bolt,96,6.9,158580,-35946421
4909,10800000,Horror,56746769,Saw V,92,5.8,95765,45946769
4910,15000000,Comedy,6409528,The Rocker,102,6.2,33768,-8590472
4911,20000000,Biography,31841299,Milk,128,7.6,145398,11841299
4912,70000000,Action,22531698,Babylon A.D.,101,5.6,85627,-47468302
4913,35000000,Comedy,80277646,What Happens in Vegas,99,6.1,149018,45277646
4914,34000000,Animation,15090400,Ponyo,101,7.7,94663,-18909600
4915,25100000,Biography,25534493,W.,129,6.3,42504,434493
4916,105000000,Action,94784201,"10,000 BC",109,5.1,114171,-10215799
4917,60000000,Comedy,143153751,Marley & Me,100,7.1,125638,83153751
4918,0,Biography,154084,Hunger,96,7.6,56117,154084
4919,130000000,Adventure,49554002,Australia,165,6.6,107593,-80445998
4920,120000000,Action,43945766,Speed Racer,135,6.0,61086,-76054234
4921,0,Biography,13823741,The Duchess,110,6.9,66399,13823741
4922,60000000,Action,19781879,The Spirit,103,4.8,55602,-40218121
4923,32000000,Action,28644813,Defiance,137,7.2,123415,-3355187
4924,16500000,Comedy,26902075,The Women,114,4.9,17778,10402075
4925,80000000,Action,101111837,Eagle Eye,118,6.6,158402,21111837
4926,12000000,Adventure,38087366,Harold & Kumar Escape from Guantanamo Bay,107,6.6,119141,26087366
4927,21000000,Comedy,3081925,"Synecdoche, New York",124,7.5,63483,-17918075
4928,20000000,Drama,33422556,Doubt,104,7.5,105844,13422556
4929,35000000,Horror,30691439,Mirrors,110,6.2,91597,-4308561
4930,80000000,Drama,79366978,The Day the Earth Stood Still,104,5.5,146633,-633022
4931,85000000,Animation,154529439,Horton Hears a Who!,86,6.8,113151,69529439
4932,17500000,Drama,58017783,Step Up 2: The Streets,98,6.2,71816,40517783
4933,20000000,Comedy,14190901,Disaster Movie,87,1.9,78142,-5809099
4934,11000000,Comedy,90559416,High School Musical 3: Senior Year,112,4.6,47545,79559416
4935,37000000,Adventure,48006503,Nim's Island,96,6.0,29611,11006503
4936,60000000,Adventure,17303424,El libro mágico,106,6.1,64411,-42696576
4937,150000000,Animation,180010950,Madagascar: Escape 2 Africa,89,6.7,162026,30010950
4938,55000000,Action,52075270,The Forbidden Kingdom,104,6.6,92275,-2924730
4939,8000000,Horror,17432844,The Ruins,90,5.9,62603,9432844
4940,30000000,Action,31715062,El transportador 3,104,6.1,136246,1715062
4941,20000000,Action,26415649,Street Kings,109,6.8,98463,6415649
4942,55000000,Comedy,33472850,Semi-Pro,91,5.8,70423,-21527150
4943,30000000,Comedy,38233676,Meet the Spartans,86,2.7,92856,8233676
4944,40000000,Crime,72266306,Vantage Point,90,6.6,132882,32266306
4945,2900000,Crime,36756,Felon,104,7.5,68957,-2863244
4946,9000000,Comedy,31487293,Nick and Norah's Infinite Playlist,90,6.7,78985,22487293
4947,55000000,Adventure,7873007,City of Ember,90,6.5,56120,-47126993
4948,80000000,Comedy,110101975,Bedtime Stories,99,6.1,76733,30101975
4949,12000000,Horror,31691811,Quarantine,89,6.0,61042,19691811
4950,30000000,Crime,15709385,Pride and Glory,130,6.7,55020,-14290615
4951,20000000,Comedy,11169531,Be Kind Rewind,102,6.4,82776,-8830469
4952,25000000,Drama,270659,Passengers,93,5.9,29805,-24729341
4953,11000000,Drama,37766350,The Secret Life of Bees,114,7.3,21142,26766350
4954,20000000,Crime,20207003,Appaloosa,115,6.8,52814,207003
4955,0,Comedy,15542,Good Dick,86,6.4,6977,15542
4956,40000000,Biography,9589875,The Express,130,7.3,17510,-30410125
4957,8000000,Comedy,12062558,Sunshine Cleaning,91,6.9,63616,4062558
4958,22000000,Crime,39263506,Lakeview Terrace,110,6.1,42915,17263506
4959,25000000,Biography,18593156,Frost/Nixon,122,7.7,92248,-6406844
4960,11500000,Crime,3045,Nothing But the Truth,108,7.2,32290,-11496955
4961,20000000,Horror,43869350,Prom Night,88,3.9,29352,23869350
4962,14700000,Comedy,1585859,"New York, I Love You",103,6.3,41273,-13114141
4963,8000000,Horror,25926543,Shutter,85,5.2,28640,17926543
4964,25000000,Crime,4597760,Deception,107,6.1,34378,-20402240
4965,0,Biography,28635,The Edge of Love,110,6.3,14339,28635
4966,15000000,Horror,83361,The Midnight Meat Train,98,6.1,51337,-14916639
4967,60000000,Action,40081410,Righteous Kill,101,6.0,76498,-19918590
4968,35000000,Action,25871834,Superhero Movie,75,4.5,55389,-9128166
4969,30000000,Drama,20981633,The X Files: I Want to Believe,104,5.9,81648,-9018367
4970,6000000,Comedy,36497,"Surfer, Dude",100,4.7,7678,-5963503
4971,40000000,Comedy,19219250,My Best Friend's Girl,101,5.9,38869,-20780750
4972,27000000,Biography,2778752,How to Lose Friends & Alienate People,110,6.5,63297,-24221248
4973,8000000,Crime,108662,Pathology,95,6.0,28065,-7891338
4974,0,Action,2411071,Ghajini,100,7.3,44436,2411071
4975,20000000,Adventure,3519627,The Brothers Bloom,114,6.8,43721,-16480373
4976,0,Drama,12796277,Rachel Getting Married,113,6.7,42934,12796277
4977,0,Drama,39373,I Can't Think Straight,82,6.7,6352,39373
4978,30000000,Drama,41850659,Nights in Rodanthe,97,6.0,19478,11850659
4979,0,Crime,1577639,Gomorrah,137,7.0,40616,1577639
4980,35000000,Crime,28687835,Untraceable,101,6.2,42864,-6312165
4981,0,Comedy,44087387,The Sisterhood of the Traveling Pants 2,119,6.2,23813,44087387
4982,12000000,Drama,3148482,Two Lovers,110,7.1,31508,-8851518
4983,20000000,Crime,200399,The Burning Plain,107,6.8,16366,-19799601
4984,0,Comedy,12081447,Soul Men,100,6.5,8179,12081447
4985,0,Comedy,12294036,Miss Pettigrew Lives for a Day,92,7.1,23423,12294036
4986,0,Crime,17007,Killshot,95,6.0,19103,17007
4987,9000000,Comedy,27696,The Hottie & the Nottie,91,1.9,34253,-8972304
4988,40000000,Comedy,32853640,Drillbit Taylor,110,5.7,52554,-7146360
4989,25000000,Drama,3073392,Ceguera,121,6.6,62356,-21926608
4990,0,Comedy,237958,Chaos Theory,87,6.7,29075,237958
4991,500000,Drama,33456317,Fireproof,100,6.6,18256,32956317
4992,0,Comedy,3494485,Happy-Go-Lucky,118,7.0,33585,3494485
4993,8500000,Horror,140244,Repo! The Genetic Opera,98,6.7,21319,-8359756
4994,12000000,Biography,8195551,Cadillac Records,109,7.0,16677,-3804449
4995,1500000,Fantasy,3478,Pontypool,93,6.7,24539,-1496522
4996,80000000,Comedy,120146040,Ni en tu casa ni en la mía,88,5.6,52146,40146040
4997,20000000,Comedy,13214030,Ghost Town,102,6.7,63093,-6785970
4998,30000000,Comedy,60269340,Baby Mama,100,6.0,36032,30269340
4999,1200000,Drama,6319,Dream Boy,90,6.2,3250,-1193681
5000,58000000,Comedy,31199215,Leatherheads,114,6.0,28721,-26800785
5001,10000000,Comedy,7563670,Over Her Dead Body,95,5.2,22072,-2436330
5002,0,Action,627047,Red Cliff,150,7.4,39046,627047
5003,35000000,Biography,1731665,Che: Part One,134,7.2,40064,-33268335
5004,40000000,Action,15279680,Bangkok Dangerous,99,5.4,50355,-24720320
5005,12000000,Horror,31418697,The Eye,98,5.4,46394,19418697
5006,62000000,Comedy,32235793,The Love Guru,87,3.8,45014,-29764207
5007,3000000,Comedy,2926565,Choke,92,6.5,29460,-73435
5008,8500000,Animation,35161554,Star Wars: The Clone Wars,98,5.9,45749,26661554
5009,15000000,Crime,2203641,Transsiberian,111,6.7,44948,-12796359
5010,25000000,Drama,10911750,Stop-Loss,112,6.5,18404,-14088250
5011,5000000,Crime,346286,The Merry Gentleman,110,6.6,2365,-4653714
5012,20000000,Drama,6414563,Brideshead Revisited,100,6.7,10581,-13585437
5013,60000000,Adventure,11802056,Meet Dave,90,4.9,33540,-48197944
5014,0,Drama,542860,Oorlogswinter,103,7.0,10819,542860
5015,5000000,Comedy,4040588,Bottle Shock,110,6.8,13051,-959412
5016,0,Drama,19853,Garden Party,88,5.6,3113,19853
5017,10000000,Crime,3607,The Oxford Murders,104,6.1,24282,-9996393
5018,0,Drama,655647,The Stoning of Soraya M.,100,8.0,15433,655647
5019,22000000,Action,23530831,Traitor,114,7.0,50958,1530831
5020,21000000,Comedy,16284360,Swing Vote,120,6.1,15740,-4715640
5021,10000000,Action,128486,The Good the Bad the Weird,120,7.3,28325,-9871514
5022,25000000,Comedy,1090947,What Just Happened,104,5.7,24511,-23909053
5023,0,Action,194287,Hell Ride,84,5.1,14535,194287
5024,27000000,Horror,26876529,One Missed Call,87,4.0,27947,-123471
5025,18000000,Crime,300000,The Informers,98,5.1,14783,-17700000
5026,1500000,Animation,2283276,Waltz with Bashir,90,8.0,48937,783276
5027,25000000,Animation,19528602,Igor,87,6.0,20476,-5471398
5028,0,Comedy,1477650,Welcome to the Sticks,106,7.1,33194,1477650
5029,20000000,Adventure,6563357,Strange Wilderness,100,5.3,19380,-13436643
5030,60000000,Animation,50877145,The Tale of Despereaux,93,6.1,32512,-9122855
5031,0,Action,476270,The Baader Meinhof Complex,150,7.4,31532,476270
5032,0,Comedy,6537,Pretty Ugly People,99,5.0,1567,6537
5033,0,Comedy,41939392,Meet the Browns,100,4.1,5913,41939392
5034,25000000,Action,6820,Mutant Chronicles,111,5.2,24230,-24993180
5035,25000000,Drama,1186957,Me and Orson Welles,114,6.8,9720,-23813043
5036,6000000,Comedy,2077116,The Wackness,99,7.0,28052,-3922884
5037,0,Drama,145109,Flame & Citron,130,7.3,15298,145109
5038,0,Adventure,45588608,College Road Trip,83,4.3,13864,45588608
5039,20000000,Adventure,94514402,Beverly Hills Chihuahua,91,3.7,18775,74514402
5040,3500000,Crime,27349,Surveillance,97,6.4,15448,-3472651
5041,0,Drama,630649,Forever Strong,100,7.3,9361,630649
5042,5000000,Drama,13350177,The Haunting of Molly Hartley,82,3.9,8232,8350177
5043,0,Crime,18378,Donkey Punch,99,5.2,9738,18378
5044,0,Comedy,37931869,First Sunday,100,4.3,8271,37931869
5045,22000000,Comedy,20668843,Mad Money,104,5.8,17753,-1331157
5046,35000000,Comedy,42436517,"Welcome Home, Roscoe Jenkins",100,5.4,11439,7436517
5047,0,Drama,3766595,The Class,128,7.5,30748,3766595
5048,8000000,Drama,3393161,Fireflies in the Garden,99,6.5,11269,-4606839
5049,45000000,Action,7916887,Miracle at St. Anna,160,6.0,16239,-37083113
5050,7000000,Drama,2344847,Redbelt,99,6.8,19183,-4655153
5051,10000000,Drama,17655201,Kit Kittredge: An American Girl,101,6.6,4988,7655201
5052,13000000,Drama,3581642,Elegy,112,6.8,20231,-9418358
5053,0,Crime,13023,The Escapist,102,6.8,15204,13023
5054,6500000,Comedy,4693919,College,100,4.6,11342,-1806081
5055,0,Action,551660,Mesrine Part 1: Killer Instinct,113,7.6,28237,551660
5056,0,Action,36569,The Red Baron,106,6.4,10306,36569
5057,0,Drama,37019849,The Family That Preys,100,5.4,6087,37019849
5058,9000000,Comedy,4881867,Hamlet 2,92,6.4,15574,-4118133
5059,10000000,Action,580862,"War, Inc.",107,5.7,20411,-9419138
5060,130000000,Action,107509799,Watchmen,162,7.6,419061,-22490201
5061,237000000,Action,760507625,Avatar,162,7.8,954412,523507625
5062,75000000,Adventure,120540719,Inglourious Basterds,153,8.3,988686,45540719
5063,150000000,Action,257730019,Star Trek,127,8.0,532987,107730019
5064,35000000,Comedy,277322503,The Hangover,100,7.8,622881,242322503
5065,250000000,Adventure,301959197,Harry Potter and the Half-Blood Prince,153,7.5,362271,51959197
5066,40000000,Animation,21002919,Fantastic Mr. Fox,87,7.8,154247,-18997081
5067,23600000,Adventure,75590286,Zombieland,88,7.7,419201,51990286
5068,25000000,Drama,83823381,Up in the Air,109,7.4,283498,58823381
5069,29000000,Biography,255959475,The Blind Side,100,7.7,242741,226959475
5070,19000000,Horror,65002019,Friday the 13th,97,5.6,80586,46002019
5071,90000000,Action,209028679,Sherlock Holmes,128,7.6,511547,119028679
5072,200000000,Action,166112167,2012,158,5.8,303766,-33887833
5073,60000000,Animation,75286229,Coraline,100,7.7,161158,15286229
5074,150000000,Action,179883157,X-Men Origins: Wolverine,107,6.7,397838,29883157
5075,175000000,Animation,293004164,Up,96,8.3,743601,118004164
5076,47000000,Drama,3600,Mr. Nobody,141,7.9,173190,-46996400
5077,11000000,Drama,3074838,Chloe,96,6.3,60262,-7925162
5078,0,Adventure,6532908,3 Idiots,170,8.4,250762,6532908
5079,7500000,Comedy,32391374,500 Days of Summer,95,7.7,407875,24891374
5080,200000000,Action,125322469,Terminator Salvation,115,6.6,301842,-74677531
5081,5000000,Drama,5009677,Moon,97,7.9,283589,9677
5082,200000000,Action,402111870,Transformers: Revenge of the Fallen,150,6.0,343549,202111870
5083,2000000,Drama,20167424,The Secret in Their Eyes,129,8.2,149747,18167424
5084,13000000,Drama,10095170,The Girl with the Dragon Tattoo,152,7.8,185107,-2904830
5085,30000000,Action,9353573,Dragonball: Evolution,85,2.6,60877,-20646427
5086,0,Drama,110248,Dogtooth,94,7.3,53533,110248
5087,0,Horror,41596251,Orphan,123,7.0,157791,41596251
5088,30000000,Sci-Fi,115646235,Sector 9,112,8.0,566581,85646235
5089,150000000,Mystery,133375846,Angels & Demons,138,6.7,232877,-16624154
5090,16000000,Comedy,16204793,Jennifer's Body,102,5.1,98187,204793
5091,11000000,Drama,397070,Anticristo,108,6.6,96352,-10602930
5092,40000000,Comedy,163958031,The Proposal,108,6.7,247443,123958031
5093,25000000,Adventure,56692,The Road,111,7.3,191196,-24943308
5094,50000000,Crime,73343413,Law Abiding Citizen,109,7.4,232508,23343413
5095,65000000,Action,67172594,Race to Witch Mountain,98,5.7,46750,2172594
5096,30000000,Drama,49200230,My Sister's Keeper,109,7.4,79925,19200230
5097,175000000,Action,152267519,G.I. Joe: The Rise of Cobra,118,5.8,182662,-22732481
5098,15000000,Crime,32721635,The Last House on the Left,110,6.6,72961,17721635
5099,85000000,Action,155064265,Fast & Furious,107,6.6,223114,70064265
5100,65000000,Drama,43818839,The Lovely Bones,135,6.7,133076,-21181161
5101,40000000,Comedy,93953653,A él no le gustas tanto,129,6.4,139962,53953653
5102,0,Horror,181467,The Human Centipede (First Sequence),92,4.4,62034,181467
5103,33000000,Action,10330853,Pandorum,108,6.8,128906,-22669147
5104,100000000,Biography,97104620,Public Enemies,140,7.0,244316,-2895380
5105,20000000,Comedy,64167069,17 Again,102,6.4,155399,44167069
5106,7000000,Drama,9166863,A Single Man,99,7.6,92447,2166863
5107,80000000,Action,38577772,Surrogates,89,6.3,157149,-41422228
5108,50000000,Adventure,296623634,The Twilight Saga: New Moon,130,4.6,232524,246623634
5109,15000000,Horror,51545952,My Bloody Valentine,101,5.5,47784,36545952
5110,105000000,Animation,104400899,The Princess and the Frog,97,7.1,97887,-599101
5111,40000000,Adventure,7689607,The Imaginarium of Doctor Parnassus,123,6.8,131731,-32310393
5112,40000000,Comedy,71440011,"I Love You, Man",105,7.0,174712,31440011
5113,40000000,Action,13838130,Cirque du Freak: The Vampire's Assistant,100,5.9,37859,-26161870
5114,0,Drama,28573173,The Uninvited,87,6.4,66806,28573173
5115,0,Drama,336467,Enter the Void,161,7.3,51942,336467
5116,35000000,Biography,11001272,The Young Victoria,100,7.3,49189,-23998728
5117,26000000,Drama,28501651,Brothers,105,7.1,94974,2501651
5118,900000,Horror,100659,The House of the Devil,95,6.4,33194,-799341
5119,15000000,Horror,33392973,Halloween II,105,4.9,39233,18392973
5120,0,Adventure,17546,Valhalla Rising,93,6.0,47214,17546
5121,38000000,Comedy,88915214,The Ugly Truth,96,6.5,175985,50915214
5122,60000000,Adventure,43337279,Year One,97,4.9,80204,-16662721
5123,20000000,Comedy,17231291,Fired Up!,90,6.2,38879,-2768709
5124,40000000,Biography,94125426,Julie & Julia,118,7.0,86198,54125426
5125,30000000,Animation,31743332,9,79,7.1,117268,1743332
5126,40000000,Horror,66477700,The Final Destination,82,5.2,81274,26477700
5127,20000000,Biography,36842118,Notorious,122,6.7,34791,16842118
5128,80000000,Drama,19664021,Nine,118,5.8,39041,-60335979
5129,5000000,Action,547292,Mother,129,7.8,31822,-4452708
5130,8500000,Biography,4444637,Bright Star,119,7.0,22535,-4055363
5131,38000000,Action,31806100,Push,111,6.1,95423,-6193900
5132,75000000,Comedy,51855045,Funny People,146,6.3,104307,-23144955
5133,10000000,Drama,47395661,Precious,110,7.3,93354,37395661
5134,11000000,Horror,27669413,El juego del miedo VI,90,6.0,83129,16669413
5135,0,Drama,12574715,An Education,100,7.3,117159,12574715
5136,50000000,Action,20488579,Gamer,95,5.8,118535,-29511421
5137,30000000,Comedy,58715510,Bride Wars,89,5.5,86156,28715510
5138,60000000,Comedy,109205660,Couples Retreat,113,5.5,87743,49205660
5139,30000000,Horror,42100625,Drag Me to Hell,99,6.6,166655,12100625
5140,50000000,Comedy,7994115,Pirate Radio,135,7.4,95825,-42005885
5141,26000000,Drama,16999046,Splice: experimento mortal,104,5.8,83205,-9000954
5142,35000000,Action,45802315,Underworld: Rise of the Lycans,92,6.6,132542,10802315
5143,20000000,Action,30101577,La hermandad,98,6.5,110514,10101577
5144,175000000,Animation,198351526,Monsters vs. Aliens,94,6.5,123919,23351526
5145,26000000,Action,20819129,Paul Blart: Mall Cop,91,5.2,89303,-5180871
5146,100000000,Action,65452312,The Taking of Pelham 123,106,6.4,160641,-34547688
5147,39000000,Drama,63414846,The Time Traveler's Wife,107,7.1,122959,24414846
5148,50000000,Drama,79957634,Knowing,121,6.2,197063,29957634
5149,7000000,Comedy,9190525,A Serious Man,106,7.0,110208,2190525
5150,100000000,Animation,124870275,Cloudy with a Chance of Meatballs,90,7.0,167156,24870275
5151,25000000,Comedy,32416109,The Men Who Stare at Goats,94,6.2,114722,7416109
5152,6000000,Comedy,4542775,Miss March,90,5.0,19111,-1457225
5153,0,Comedy,16025394,Adventureland,100,6.8,139072,16025394
5154,16000000,Drama,15045676,The Box,115,5.6,80381,-954324
5155,6000000,Horror,7706394,The Collector,90,6.4,47291,1706394
5156,60000000,Biography,37491364,Invictus,134,7.4,132427,-22508636
5157,0,Crime,29062561,The Stepfather,101,5.6,25186,29062561
5158,150000000,Adventure,177243721,Night at the Museum: Battle of the Smithsonian,105,5.9,143636,27243721
5159,100000000,Adventure,49438370,Land of the Lost,102,5.4,54864,-50561630
5160,26000000,Horror,13248477,Case 39,109,6.2,65254,-12751523
5161,85000000,Comedy,112735375,It's Complicated,100,6.6,74245,27735375
5162,100000000,Adventure,77233467,Donde viven los monstruos,101,6.8,91833,-22766533
5163,20000000,Action,13630226,Crank: High Voltage,96,6.2,121567,-6369774
5164,7000000,Drama,39462438,Crazy Heart,112,7.3,73161,32462438
5165,16000000,Drama,42670410,The Unborn,88,4.8,44283,26670410
5166,35000000,Comedy,73034460,Hotel para perros,100,5.4,17784,38034460
5167,30000000,Comedy,79566871,Hannah Montana: The Movie,102,4.3,34118,49566871
5168,0,Crime,9081782,The Girl Who Played with Fire,129,7.2,78771,9081782
5169,70000000,Adventure,617840,Agora,127,7.2,56850,-69382160
5170,20000000,Drama,68261644,Obsessed,108,4.9,24499,48261644
5171,0,Drama,37017955,State of Play,127,7.1,118835,37017955
5172,0,Comedy,249590,Spread,97,5.9,34153,249590
5173,42000000,Comedy,60054530,Brüno,81,5.8,125840,18054530
5174,10000000,Mystery,25464480,The Fourth Kind,98,5.9,66304,15464480
5175,0,Drama,55389516,The Haunting in Connecticut,92,5.9,53262,55389516
5176,40000000,Action,38105077,Ninja Assassin,99,6.4,60987,-1894923
5177,0,Comedy,90485233,Madea Goes to Jail,103,4.3,10052,90485233
5178,15000000,Comedy,5306447,Whatever Works,93,7.2,62933,-9693553
5179,35000000,Action,10275638,Whiteout,101,5.5,33530,-24724362
5180,0,Drama,106662,About Elly,119,8.1,31740,106662
5181,22000000,Comedy,723714,Middle Men,105,6.6,33978,-21276286
5182,0,Comedy,55250026,Ghosts of Girlfriends Past,100,5.8,71836,55250026
5183,18500000,Comedy,18439082,The Invention of Lying,100,6.4,99595,-60918
5184,8000000,Comedy,10814185,Extract,92,6.2,39493,2814185
5185,90000000,Animation,196573705,Ice Age: Dawn of the Dinosaurs,94,7.0,182575,106573705
5186,0,Crime,2084637,A Prophet,155,7.9,83124,2084637
5187,0,Comedy,2384044,In the Loop,106,7.5,47137,2384044
5188,75000000,Animation,219614612,Alvin and the Chipmunks: The Squeakquel,88,4.5,34731,144614612
5189,14000000,Adventure,15483540,A Perfect Getaway,98,6.5,59667,1483540
5190,15000000,Drama,13043363,Whip It,111,6.9,58138,-1956637
5191,200000000,Animation,137855863,A Christmas Carol,96,6.8,80819,-62144137
5192,0,Drama,2222647,The White Ribbon,144,7.8,57685,2222647
5193,50000000,Action,25450527,The International,118,6.5,83114,-24549473
5194,0,Comedy,44277350,Confessions of a Shopaholic,104,5.9,66680,44277350
5195,35000000,Comedy,49492060,Old Dogs,100,5.4,32674,14492060
5196,0,Drama,373060,Fish Tank,123,7.3,51481,373060
5197,0,Action,23036320,Fighting,105,5.6,29024,23036320
5198,8000000,Action,10269307,The Boondock Saints II: All Saints Day,118,6.3,55823,2269307
5199,17000000,Crime,27154426,Brooklyn's Finest,132,6.7,55183,10154426
5200,2900000,Action,228477,Black Dynamite,84,7.4,38535,-2671523
5201,22000000,Comedy,33313582,The Informant!,108,6.5,55457,11313582
5202,18000000,Comedy,23993605,Observe and Report,86,5.8,54428,5993605
5203,13000000,Biography,2035566,Una pareja dispareja,102,6.6,82466,-10964434
5204,15000000,Comedy,33860010,All About Steve,99,4.8,34902,18860010
5205,1700000,Drama,695417,The Girlfriend Experience,77,5.5,14416,-1004583
5206,18000000,Comedy,22455510,Fame,107,5.0,14706,4455510
5207,18000000,Comedy,14793904,"I Love You, Beth Cooper",102,5.3,29845,-3206096
5208,18000000,Comedy,15281286,Youth in Revolt,90,6.5,67707,-2718714
5209,0,Crime,5188972,The Girl Who Kicked the Hornet's Nest,147,7.3,57185,5188972
5210,60000000,Comedy,40572825,Duplicity,125,6.2,43170,-19427175
5211,17000000,Comedy,9451946,Away We Go,98,7.1,47589,-7548054
5212,3900000,Adventure,688529,Fanboys,100,6.6,51872,-3211471
5213,7300000,Action,1818681,Harry Brown,103,7.2,77350,-5481319
5214,8000000,Comedy,16734283,New in Town,97,5.6,18623,8734283
5215,0,Drama,5005465,I Am Love,120,7.0,15445,5005465
5216,0,Adventure,2534351,Sin Nombre,96,7.6,27573,2534351
5217,20000000,Crime,1697956,Bad Lieutenant: Port of Call New Orleans,122,6.7,67565,-18302044
5218,5000000,Drama,296441,Thirst,133,7.2,33954,-4703559
5219,16000000,Horror,11956207,Sorority Row,101,5.1,25255,-4043793
5220,60000000,Biography,31670931,The Soloist,117,6.7,45900,-28329069
5221,4500000,Drama,108229,After.Life,100,5.9,32597,-4391771
5222,0,Drama,17595,Cracks,104,6.7,16664,17595
5223,800000,Comedy,41709,Dead Snow,100,6.3,57777,-758291
5224,0,Biography,1445366,Nowhere Boy,98,7.2,30580,1445366
5225,0,Action,17365,Bitch Slap,109,4.5,12478,17365
5226,0,Comedy,15388,Paper Man,110,6.6,16398,15388
5227,0,Drama,1808,Now & Later,99,5.2,1040,1808
5228,0,Biography,6109075,Coco Before Chanel,105,6.7,34008,6109075
5229,45000000,Animation,25200412,Aliens in the Attic,86,5.4,17909,-19799588
5230,0,Action,36039,District 13: Ultimatum,101,6.5,39096,36039
5231,18000000,Action,8742261,Street Fighter: La leyenda,96,3.7,20580,-9257739
5232,0,Animation,686383,The Secret of Kells,100,7.7,25381,686383
5233,21000000,Adventure,8855646,Everybody's Fine,100,7.2,52792,-12144354
5234,150000000,Animation,119436770,G-Force,88,5.1,35516,-30563230
5235,18000000,Drama,22927390,Love Happens,100,5.6,27008,4927390
5236,0,Comedy,221210,World's Greatest Dad,99,6.9,33634,221210
5237,40000000,Comedy,20916309,Shorts,89,4.8,5645,-19083691
5238,19000000,Crime,454149,Crossing Over,113,6.8,20514,-18545851
5239,5000000,Drama,1474508,The Joneses,96,6.5,35116,-3525492
5240,70000000,Adventure,35922978,The Pink Panther 2,92,5.6,35845,-34077022
5241,0,Drama,90820,Carriers,100,6.0,37265,90820
5242,0,Action,828,Perrier's Bounty,88,6.4,5514,828
5243,65000000,Animation,19548064,Astro Boy,94,6.3,27771,-45451936
5244,70000000,Animation,42086887,Planeta 51,91,6.1,43788,-27913113
5245,0,Drama,20585,Love and Other Impossible Pursuits,119,6.4,16454,20585
5246,58000000,Comedy,29580087,Did You Hear About the Morgans?,100,4.8,31604,-28419913
5247,23000000,Comedy,2708188,Chéri,100,6.2,9380,-20291812
5248,0,Comedy,400654,Today's Special,99,6.7,4749,400654
5249,22000000,Action,12232937,12 Rounds,108,5.6,24250,-9767063
5250,40000000,Adventure,14241034,Amelia,111,5.8,10609,-25758966
5251,18000000,Drama,5014305,Broken Embraces,127,7.2,33400,-12985695
5252,30000000,Biography,7443007,Taking Woodstock,120,6.7,25866,-22556993
5253,5600000,Horror,27766,[Rec] 2,85,6.6,59366,-5572234
5254,0,Comedy,15102127,"The Goods: Live Hard, Sell Hard",89,5.8,18361,15102127
5255,10000000,Biography,449558,The Damned United,98,7.6,34976,-9550442
5256,3500000,Comedy,44462,Defendor,101,6.8,32840,-3455538
5257,27000000,Action,15988876,Armored,88,5.7,27251,-11011124
5258,15000000,Comedy,4360548,Solitary Man,90,6.4,14100,-10639452
5259,0,Comedy,1425993,I Hope They Serve Beer in Hell,105,5.3,7631,1425993
5260,17000000,Comedy,8662318,My Life in Ruins,98,5.9,16145,-8337682
5261,6000000,Comedy,6670712,City Island,104,7.4,28292,670712
5262,800000,Crime,166980,The Disappearance of Alice Creed,100,6.8,22135,-633020
5263,0,Drama,2277396,Adam,99,7.2,30860,2277396
5264,0,Crime,425025,The Limits of Control,116,6.3,17001,425025
5265,8000000,Comedy,100503,The Good Guy,100,5.9,8288,-7899497
5266,4000000,Comedy,101740,Survival of the Dead,90,4.9,18336,-3898260
5267,6500000,Drama,66637,The Messenger,113,7.2,30893,-6433363
5268,0,Comedy,41588,The Slammin' Salmon,100,6.5,11324,41588
5269,0,Animation,78182,Summer Wars,114,7.6,19440,78182
5270,7500000,Drama,9176553,Get Low,103,7.1,19987,1676553
5271,12000000,Drama,548934,Ondine,111,6.8,17919,-11451066
5272,5000000,Drama,518522,Tetro,127,6.9,11077,-4481478
5273,0,Comedy,77126,Mystery Team,97,6.8,7956,77126
5274,0,Biography,6616974,The Last Station,112,7.0,16078,6616974
5275,10000000,Thriller,1785,The Canyon,100,5.9,3453,-9998215
5276,13000000,Comedy,51733921,I Can Do Bad All by Myself,100,4.2,8640,38733921
5277,0,Animation,347136,Arthur and the Revenge of Maltazard,93,5.3,6110,347136
5278,3000000,Drama,5005,Tanner Hall,96,5.9,2545,-2994995
5279,25000000,Crime,32409,Beyond a Reasonable Doubt,106,5.9,11153,-24967591
5280,160000000,Action,292576195,Inception,148,8.8,1629342,132576195
5281,13000000,Drama,106954678,Black Swan,108,8.0,594148,93954678
5282,60000000,Action,31494270,Scott Pilgrim vs. the World,112,7.5,302029,-28505730
5283,80000000,Mystery,128012934,Shutter Island,138,8.1,883895,48012934
5284,0,Adventure,295983305,Harry Potter and the Deathly Hallows: Part 1,146,7.7,368576,295983305
5285,30000000,Action,48071303,Kick-Ass,117,7.7,465530,18071303
5286,20000000,Comedy,31584722,She's Out of My League,100,6.4,107464,11584722
5287,125000000,Action,163214888,Clash of the Titans,106,5.8,241875,38214888
5288,6800000,Drama,6857096,Incendies,131,8.2,97935,57096
5289,1500000,Horror,54009150,Insidious,103,6.8,226632,52509150
5290,40000000,Biography,96962694,The Social Network,120,7.7,521956,56962694
5291,69000000,Animation,251513985,Despicable Me,95,7.7,422190,182513985
5292,37000000,Crime,92186262,The Town,125,7.6,299626,55186262
5293,260000000,Animation,200821936,Tangled,100,7.8,325621,-59178064
5294,95000000,Adventure,88761720,Percy Jackson & the Olympians: The Lightning Thief,118,5.9,152255,-6238280
5295,15000000,Biography,138797449,The King's Speech,118,8.0,544927,123797449
5296,8000000,Comedy,58401464,Easy A,92,7.1,301623,50401464
5297,200000000,Action,312433331,Iron Man 2,124,7.0,571416,112433331
5298,30000000,Comedy,32367005,Love & Other Drugs,112,6.7,154701,2367005
5299,170000000,Action,172062763,TRON: Legacy,100,6.8,278124,2062763
5300,26000000,Action,40168080,Legion,100,5.2,85724,14168080
5301,200000000,Adventure,334191110,Alice in Wonderland,108,6.5,331389,134191110
5302,38000000,Adventure,171243005,True Grit,110,7.6,259855,133243005
5303,35000000,Horror,63075011,A Nightmare on Elm Street,95,5.2,79930,28075011
5304,58000000,Action,90380162,RED,111,7.1,254554,32380162
5305,80000000,Action,94835059,The Book of Eli,118,6.9,246433,14835059
5306,100000000,Comedy,95347692,Sex and the City 2,146,4.4,63699,-4652308
5307,110000000,Action,77222099,The A-Team,117,6.8,222505,-32777901
5308,117000000,Action,76423035,Knight and Day,109,6.3,157815,-40576965
5309,200000000,Animation,415004880,Toy Story 3,103,8.3,603472,215004880
5310,3500000,Drama,9737892,Blue Valentine,112,7.4,154714,6237892
5311,2000000,Crime,93051,I Spit on Your Grave,108,6.3,61717,-1906949
5312,165000000,Animation,217581231,How to Train Your Dragon,98,8.1,538360,52581231
5313,16000000,Drama,19068240,Remember Me,113,7.2,121432,3068240
5314,200000000,Action,90759676,Prince of Persia: The Sands of Time,116,6.6,237542,-109240324
5315,0,Comedy,4216789,Greenberg,107,6.1,31477,4216789
5316,25000000,Biography,93617009,The Fighter,116,7.8,294996,68617009
5317,15000000,Drama,2434652,Never Let Me Go,103,7.2,118784,-12565348
5318,80000000,Comedy,162001186,Grown Ups,102,6.0,194404,82001186
5319,35000000,Comedy,29197642,Nanny McPhee Returns,109,6.1,21695,-5802358
5320,20000000,Horror,45710178,Saw 3D: The Final Chapter,90,5.6,74021,25710178
5321,0,Comedy,223838,Tucker and Dale vs Evil,89,7.6,140517,223838
5322,200000000,Action,105269730,Robin Hood,140,6.7,224548,-94730270
5323,110000000,Action,118311368,Salt,100,6.4,259831,8311368
5324,80000000,Action,103068524,The Expendables,103,6.5,288429,23068524
5325,150000000,Action,131564731,The Last Airbender,103,4.2,127467,-18435269
5326,38000000,Comedy,53374681,Life as We Know It,100,6.6,103763,15374681
5327,55000000,Comedy,98711404,Date Night,88,6.3,135458,43711404
5328,55000000,Drama,39440655,Burlesque,119,6.4,65689,-15559345
5329,18000000,Adventure,18335230,127 Hours,94,7.6,299503,335230
5330,40000000,Action,52000688,Predators,107,6.4,182863,12000688
5331,35000000,Crime,21148651,The Next Three Days,133,7.4,155358,-13851349
5332,100000000,Action,119219978,The Other Guys,107,6.7,204044,19219978
5333,19000000,Comedy,25918920,Leap Year,100,6.5,77685,6918920
5334,40000000,Action,176591618,The Karate Kid,140,6.2,131784,136591618
5335,68000000,Adventure,300531751,The Twilight Saga: Eclipse,124,4.9,195941,232531751
5336,0,Comedy,304137,Four Lions,97,7.3,61262,304137
5337,0,Crime,578382,All Good Things,101,6.3,45225,578382
5338,55000000,Comedy,32669555,When in Rome,91,5.6,53883,-22330445
5339,2000000,Drama,6531503,Winter's Bone,100,7.2,118433,4531503
5340,24000000,Comedy,25003155,Piranha 3D,88,5.5,76489,1003155
5341,36000000,Comedy,50287556,Hot Tub Time Machine,101,6.4,145648,14287556
5342,100000000,Action,81562942,Unstoppable,98,6.8,160551,-18437058
5343,24000000,Action,23240020,Faster,98,6.5,85407,-759980
5344,12000000,Action,122288,Centurion,97,6.4,69188,-11877712
5345,15000000,Adventure,26161406,Ramona and Beezus,100,6.7,14808,11161406
5346,0,Action,128392,I Saw the Devil,141,7.8,81507,128392
5347,15000000,Comedy,64003625,Diary of a Wimpy Kid,100,6.2,35256,49003625
5348,52000000,Comedy,110485654,Valentine's Day,125,5.7,100570,58485654
5349,80000000,Crime,43313890,Edge of Darkness,117,6.6,79774,-36686110
5350,44000000,Drama,31162545,Charlie St. Cloud,100,6.5,50872,-12837455
5351,20000000,Drama,12134420,Let Me In,116,7.2,99166,-7865580
5352,130000000,Animation,148415853,Megamind,95,7.3,188234,18415853
5353,3000000,Drama,1028658,Sepultado,95,7.0,127979,-1971342
5354,165000000,Animation,238371987,Shrek Forever After,93,6.3,150636,73371987
5355,14000000,Comedy,1752214,Flipped,100,7.7,67346,-12247786
5356,100000000,Action,67631157,The Tourist,103,6.0,190376,-32368843
5357,20000000,Comedy,25702053,You Again,100,5.8,43588,5702053
5358,155000000,Adventure,104386950,The Chronicles of Narnia: The Voyage of the Dawn Treader,113,6.3,116260,-50613050
5359,10500000,Action,26593646,Machete,105,6.6,173229,16093646
5360,0,Drama,237301,Monsters,94,6.4,80354,237301
5361,150000000,Action,63150991,The Sorcerer's Apprentice,109,6.1,133390,-86849009
5362,70000000,Drama,52474616,Wall Street: Money Never Sleeps,133,6.2,88518,-17525384
5363,0,Action,6460,The Man from Nowhere,119,7.8,48823,6460
5364,25000000,Drama,80014842,Dear John,108,6.3,115712,55014842
5365,60000000,Drama,80574010,Eat Pray Love,133,5.7,69859,20574010
5366,65000000,Comedy,100539043,Due Date,95,6.6,287021,35539043
5367,0,Action,1120914,Secretos Peligrosos,112,7.2,27033,1120914
5368,25000000,Action,23580735,The Losers,97,6.4,78545,-1419265
5369,20000000,Horror,39123589,The Crazies,101,6.5,98210,19123589
5370,8000000,Comedy,6350058,It's Kind of a Funny Story,101,7.1,116014,-1649942
5371,100000000,Comedy,148383780,Little Fockers,98,5.5,91634,48383780
5372,2500000,Comedy,322157,Super,100,6.8,65689,-2177843
5373,0,Comedy,60974475,Get Him to the Greek,109,6.4,153864,60974475
5374,0,Adventure,2701859,The Way Back,133,7.3,94377,2701859
5375,20000000,Drama,62950384,The Last Song,100,5.9,66108,42950384
5376,0,Action,22554,Black Death,102,6.4,38417,22554
5377,0,Crime,1044039,Animal Kingdom,113,7.3,48461,1044039
5378,0,Comedy,10822,Elektra Luxx,100,5.1,6197,10822
5379,60000000,Action,60128566,Resident Evil: Afterlife,96,5.9,143707,128566
5380,0,Drama,5101237,Biutiful,148,7.5,74415,5101237
5381,10000000,Horror,33583175,Devil,80,6.3,112284,23583175
5382,19000000,Comedy,27758465,The Switch,100,6.1,83839,8758465
5383,45000000,Drama,15541549,The Ghost Writer,128,7.2,140059,-29458451
5384,150000000,Drama,61979680,The Wolfman,103,5.8,93175,-88020320
5385,0,Drama,98986,Last Night,93,6.6,41908,98986
5386,20000000,Action,57744720,Takers,107,6.2,49828,37744720
5387,47000000,Action,10539414,Jonah Hex,81,4.7,48504,-36460586
5388,0,Comedy,255179,Boy,87,7.5,11504,255179
5389,35000000,Comedy,37490007,The Back-up Plan,104,5.3,43272,2490007
5390,40000000,Action,67061228,The Bounty Hunter,110,5.5,103868,27061228
5391,10000000,Biography,3571735,The Runaways,106,6.6,41586,-6428265
5392,0,Comedy,466702,Submarine,97,7.3,72965,466702
5393,10000000,Action,21371425,Skyline,97,4.4,78787,11371425
5394,120000000,Comedy,30212620,How Do You Know,100,5.4,37605,-89787380
5395,0,Thriller,243390,Frozen,93,6.2,57244,243390
5396,7000000,Comedy,1768416,Somewhere,97,6.3,38036,-5231584
5397,20000000,Drama,31177548,The Debt,113,6.9,57945,11177548
5398,3200000,Comedy,5790894,Beginners,105,7.2,78833,2590894
5399,75000000,Action,47059963,Killers,100,5.4,77029,-27940037
5400,0,Adventure,4430650,The Way,100,7.4,25187,4430650
5401,30000000,Adventure,53032453,Letters to Juliet,100,6.6,79868,23032453
5402,5000000,Drama,2229058,Rabbit Hole,91,7.0,42926,-2770942
5403,9500000,Crime,120016,Trust,106,6.9,36805,-9379984
5404,0,Drama,252652,Trollhunter,103,7.0,58841,252652
5405,52000000,Action,23979741,París en la Mira,92,6.5,102224,-28020259
5406,0,Comedy,73026337,Dinner for Schmucks,114,5.9,84651,73026337
5407,100000000,Action,35053660,Green Zone,115,6.8,116142,-64946340
5408,3500000,Comedy,20811365,The Kids Are All Right,106,7.1,115520,17311365
5409,50000000,Drama,32746941,Hereafter,129,6.5,83345,-17253059
5410,28000000,Action,24268828,The Spy Next Door,94,5.4,33070,-3731172
5411,20000000,Crime,35606376,The American,105,6.3,82995,15606376
5412,8000000,Action,117190,Wild Target,98,6.9,31864,-7882810
5413,6000000,Action,802524,13 Assassins,141,7.6,54145,-5197476
5414,80000000,Animation,55675313,Legend of the Guardians: The Owls of Ga'Hoole,97,7.0,69624,-24324687
5415,22000000,Biography,9528092,Fair Game,108,6.8,40837,-12471908
5416,37000000,Action,44875481,Cop Out,107,5.6,78157,7875481
5417,30000000,Drama,42400223,Step Up 3D,107,6.2,50180,12400223
5418,23000000,Animation,19202743,The Secret World of Arrietty,94,7.6,59799,-3797257
5419,20000000,Comedy,42739347,Death at a Funeral,92,5.7,38627,22739347
5420,25000000,Fantasy,24042490,Don't Be Afraid of the Dark,99,5.6,42545,-957510
5421,12000000,Adventure,4018695,My Name Is Khan,165,8.0,81130,-7981305
5422,32000000,Action,13794835,Repo Men,111,6.3,91561,-18205165
5423,20000000,Adventure,36661504,Vampires Suck,82,3.5,41062,16661504
5424,40000000,Comedy,31011732,Morning Glory,100,6.5,62536,-8988268
5425,15000000,Drama,4439063,The Company Men,104,6.8,38636,-10560937
5426,0,Comedy,408719,I'm Still Here,108,6.2,17059,408719
5427,48000000,Comedy,60022256,Tooth Fairy,101,5.0,33336,12022256
5428,650000,Drama,18469,Stake Land,98,6.5,36801,-631531
5429,0,Comedy,7502560,La versión de mi vida,134,7.3,22030,7502560
5430,35000000,Biography,59713955,Secretariat,123,7.2,22288,24713955
5431,500000,Comedy,98017,Rubber,82,5.8,28442,-401983
5432,0,Comedy,560101,Tamara Drewe,107,6.2,18147,560101
5433,22000000,Comedy,3247816,You Will Meet a Tall Dark Stranger,100,6.3,39014,-18752184
5434,0,Action,205675,Ip Man 2,108,7.6,78917,205675
5435,13000000,Crime,214966,The Killer Inside Me,109,6.1,30060,-12785034
5436,112000000,Adventure,42779261,Gulliver's Travels,85,4.9,56336,-69220739
5437,25000000,Comedy,206088,Little White Lies,134,7.1,20148,-24793912
5438,10000000,Action,8460995,MacGruber,90,5.5,37743,-1539005
5439,3000000,Horror,84752907,Paranormal Activity 2,91,5.7,87197,81752907
5440,1800000,Drama,41034350,El último exorcismo,87,5.6,43587,39234350
5441,22000000,Drama,1796024,Stone,105,5.4,36456,-20203976
5442,32000000,Comedy,17804299,Going the Distance,100,6.3,52508,-14195701
5443,7000000,Comedy,382946,Hesher,106,7.1,46153,-6617054
5444,0,Drama,62985,Heartbeats,101,7.2,21449,62985
5445,8000000,Drama,3669,Passion Play,94,5.0,7540,-7996331
5446,0,Action,188870,Easy Money,124,6.7,14513,188870
5447,4000000,Comedy,53630,Dirty Girl,90,6.5,9432,-3946370
5448,12500000,Biography,6783129,Conviction,107,7.2,37145,-5716871
5449,0,Action,100119,Elite Squad: The Enemy Within,115,8.1,70700,100119
5450,25000000,Crime,6911,London Boulevard,103,6.2,42460,-24993089
5451,25000000,Crime,11538204,The Conspirator,122,6.9,25030,-13461796
5452,0,Comedy,25517,Waiting for Forever,100,6.0,18609,25517
5453,20000000,Comedy,277943,The Tempest,110,5.4,6589,-19722057
5454,7000000,Comedy,7455447,Cyrus,91,6.3,31320,455447
5455,80000000,Animation,100246011,Yogi Bear,100,4.6,17533,20246011
5456,15000000,Drama,20218921,Country Strong,117,6.3,15478,5218921
5457,0,Comedy,2014922,The Trip,112,7.0,18884,2014922
5458,500000,Comedy,48430,The Perfect Host,100,6.8,21832,-451570
5459,0,Sci-Fi,56129,Beyond the Black Rainbow,110,6.0,7662,56129
5460,10000000,Comedy,4833,Burke and Hare,91,6.2,17228,-9995167
5461,0,Drama,977600,Meek's Cutoff,104,6.6,9252,977600
5462,0,Comedy,116478,Kaboom,86,5.7,11100,116478
5463,0,Drama,1008098,In a Better World,100,7.7,34566,1008098
5464,25000000,Biography,134904,Love Ranch,100,5.7,2558,-24865096
5465,7200000,Biography,1094798,Made in Dagenham,113,7.2,11904,-6105202
5466,4500000,Comedy,103280,The Romantics,100,5.1,10547,-4396720
5467,0,Action,181591,Twelve,100,5.7,11139,181591
5468,0,Comedy,40029,The Last Circus,107,6.6,11108,40029
5469,5000000,Comedy,2711210,Everything Must Go,97,6.4,43290,-2288790
5470,45000000,Action,5664251,The Warrior's Way,100,6.3,23178,-39335749
5471,25000000,Horror,14637490,My Soul to Take,100,4.8,17312,-10362510
5472,31000000,Drama,11854694,Extraordinary Measures,106,6.5,14980,-19145306
5473,0,Drama,37721949,For Colored Girls,100,6.0,6359,37721949
5474,800000,Comedy,62000,Hatchet II,85,5.5,10103,-738000
5475,50000000,Comedy,33644788,Marmaduke,100,4.2,12104,-16355212
5476,0,Comedy,504030,Heartbreaker,105,6.8,22456,504030
5477,0,Comedy,215576,Happythankyoumoreplease,100,6.8,27342,215576
5478,0,Drama,23787,La vida según Attenberg,97,6.2,4798,23787
5479,0,Comedy,85789,A Little Help,100,5.7,2787,85789
5480,0,Drama,558342,Even the Rain,103,7.5,10681,558342
5481,0,Thriller,20960,Red Hill,95,6.4,7518,20960
5482,0,Drama,149757,The Housemaid,106,6.5,7482,149757
5483,20000000,Action,1183354,Dylan Dog: Dead of Night,100,5.1,13559,-18816646
5484,0,Drama,1337384,Certified Copy,106,7.3,16271,1337384
5485,15000000,Biography,1039869,Casino Jack,108,6.2,15443,-13960131
5486,0,Action,1602466,Kites: Más allá de las fronteras,123,6.1,10542,1602466
5487,0,Drama,7691700,La llave de Sarah,102,7.5,13938,7691700
5488,12000000,Comedy,101882,Henry's Crime,108,6.0,16513,-11898118
5489,0,Drama,152857,Welcome to the Rileys,100,7.0,21126,152857
5490,0,Biography,693181,Frankie & Alice,100,6.5,4201,693181
5491,0,Drama,13068,Norwegian Wood,133,6.4,9497,13068
5492,85000000,Action,43585753,Cats & Dogs: The Revenge of Kitty Galore,100,4.3,11161,-41414247
5493,35000000,Comedy,17596256,Furry Vengeance,100,3.8,13245,-17403744
5494,0,Comedy,183605,Uncle Boonmee Who Can Recall His Past Lives,114,6.6,10329,183605
5495,0,Comedy,1017335,Guzaarish,126,7.5,13312,1017335
5496,0,Comedy,3205706,Another Year,129,7.3,24862,3205706
5497,10000000,Horror,22197,Vanishing on 7th Street,92,4.9,22864,-9977803
5498,65000,Comedy,389804,Tiny Furniture,98,6.2,12702,324804
5499,20000000,Animation,25077977,Alpha and Omega,90,5.3,11636,5077977
5500,125000000,Adventure,381011219,Harry Potter and the Deathly Hallows: Part 2,130,8.1,608969,256011219
5501,163000000,Action,100240551,Cowboys & Aliens,119,6.0,182868,-62759449
5502,250000000,Action,241071802,Pirates of the Caribbean: On Stranger Tides,100,6.6,408968,-8928198
5503,15000000,Crime,35060689,Drive,100,7.8,472901,20060689
5504,25000000,Drama,169708112,The Help,146,8.1,351321,144708112
5505,50000000,Comedy,84351197,"Crazy, Stupid, Love.",100,7.4,404694,34351197
5506,90000000,Crime,102515793,The Girl with the Dragon Tattoo,158,7.8,356094,12515793
5507,0,Drama,24149393,El espía que sabía demasiado,122,7.1,160451,24149393
5508,32500000,Comedy,169106725,Bridesmaids,125,6.8,232190,136606725
5509,82000000,Action,36392502,Sucker Punch,110,6.1,207858,-45607498
5510,150000000,Action,181030624,Thor,115,7.0,585830,31030624
5511,0,Biography,13182281,The Intouchables,112,8.6,579143,13182281
5512,140000000,Action,176654505,Captain America: The First Avenger,124,6.9,563504,36654505
5513,25000000,Drama,13657115,Warrior,140,8.2,365224,-11342885
5514,160000000,Action,146408305,X-Men: First Class,132,7.8,561501,-13591695
5515,200000000,Action,116601172,Green Lantern,114,5.6,235591,-83398828
5516,27000000,Mystery,79249455,Limitless,105,7.4,454361,52249455
5517,75000000,Action,83504017,Immortals,110,6.0,144952,8504017
5518,50000000,Mystery,127004179,Super 8,112,7.0,303656,77004179
5519,93000000,Action,176760185,Rise of the Planet of the Apes,105,7.6,439105,83760185
5520,60000000,Action,29136626,Priest,87,5.7,102144,-30863374
5521,195000000,Action,352390543,Transformers: Dark of the Moon,154,6.3,345669,157390543
5522,40000000,Action,37520095,In Time,109,6.7,324606,-2479905
5523,50000000,Comedy,75624550,We Bought a Zoo,124,7.1,118916,25624550
5524,17000000,Comedy,56816662,Midnight in Paris,100,7.7,327869,39816662
5525,32000000,Mystery,54712227,Source Code,93,7.5,414859,22712227
5526,145000000,Action,209397903,Mission: Impossible - Ghost Protocol,132,7.4,388730,64397903
5527,80000000,Comedy,103028109,Just Go with It,117,6.4,185840,23028109
5528,40000000,Crime,58009200,The Lincoln Lawyer,118,7.3,184728,18009200
5529,35000000,Comedy,117538559,Horrible Bosses,106,6.9,375032,82538559
5530,60000000,Action,55100437,I Am Number Four,109,6.1,205616,-4899563
5531,6500000,Drama,4000304,Shame,101,7.2,158515,-2499696
5532,40000000,Horror,38180928,Scream 4,111,6.2,110371,-1819072
5533,35000000,Comedy,55802754,Friends with Benefits,109,6.6,292555,20802754
5534,20000000,Comedy,100292856,Bad Teacher,92,5.7,169725,80292856
5535,150000000,Adventure,73864507,Hugo,126,7.5,264187,-76135493
5536,1000000,Horror,18474268,You're Next,95,6.5,70259,17474268
5537,50000000,Biography,75605492,Moneyball,133,7.6,302465,25605492
5538,15000000,Drama,13843771,One Day,107,7.0,116446,-1156229
5539,0,Comedy,4168144,Goon,92,6.8,75386,4168144
5540,25000000,Comedy,70662220,No Strings Attached,108,6.2,181844,45662220
5541,110000000,Adventure,281287133,The Twilight Saga: Breaking Dawn - Part 1,117,4.9,193280,171287133
5542,7000000,Drama,1738692,We Need to Talk About Kevin,112,7.5,108592,-5261308
5543,125000000,Action,186848418,Sherlock Holmes: A Game of Shadows,129,7.5,365008,61848418
5544,7400000,Drama,3029870,Melancolía,135,7.1,140218,-4370130
5545,125000000,Action,209837675,Fast Five,130,7.3,307369,84837675
5546,30000000,Action,40259119,Hanna,111,6.8,166517,10259119
5547,50200000,Romance,62495645,The Adjustment Bureau,106,7.1,211918,12295645
5548,13000000,Drama,3185812,La piel que habito,120,7.6,112125,-9814188
5549,25000000,Action,51580136,The Grey,117,6.8,214403,26580136
5550,110000000,Action,85468508,Real Steel,127,7.1,268336,-24531492
5551,135000000,Animation,123477607,Rango,107,7.2,198267,-11522393
5552,6000000,Drama,4106,The Good Doctor,91,5.6,5532,-5995894
5553,38000000,Horror,16928670,The Thing,103,6.2,102345,-21071330
5554,90000000,Action,21295021,Conan the Barbarian,113,5.2,85864,-68704979
5555,32000000,Drama,13303319,The Tree of Life,139,6.8,146243,-18696681
5556,20000000,Comedy,82584160,The Descendants,115,7.3,213733,62584160
5557,40000000,Adventure,37412945,Paul,104,7.0,205426,-2587055
5558,52000000,Comedy,37081475,The Change-Up,112,6.3,144130,-14918525
5559,60000000,Drama,75658097,Contagion,106,6.6,189798,15658097
5560,500000,Drama,7098492,A Separation,123,8.4,170427,6598492
5561,24000000,Comedy,51802742,Footloose,113,5.9,40132,27802742
5562,35000000,Action,28087155,Abduction,106,5.1,68380,-6912845
5563,11000000,Crime,1987762,Killer Joe,102,6.7,63334,-9012238
5564,18000000,Biography,43853424,Soul Surfer,112,7.1,38348,25853424
5565,75000000,Action,20377913,The Three Musketeers,110,5.8,93671,-54622087
5566,8000000,Comedy,35014192,50/50,100,7.7,285675,27014192
5567,36000000,Comedy,45060734,Hall Pass,105,5.9,108256,9060734
5568,0,Drama,37710,Sleeping Beauty,101,5.3,27413,37710
5569,80000000,Comedy,254464305,The Hangover Part II,102,6.5,402097,174464305
5570,200000000,Animation,191452396,Cars 2,106,6.2,116477,-8547604
5571,1100000,Action,4105123,The Raid: Redemption,101,7.6,160867,3005123
5572,0,Drama,11242660,Jane Eyre,120,7.4,69029,11242660
5573,135000000,Animation,77591831,The Adventures of Tintin,107,7.4,188070,-57408169
5574,40000000,Action,36665854,Colombiana,108,6.4,81197,-3334146
5575,49900000,Adventure,21596445,Your Highness,102,5.6,89047,-28303555
5576,66000000,Drama,79884879,War Horse,146,7.2,125204,13884879
5577,0,Biography,5702083,A Dangerous Method,99,6.5,86882,5702083
5578,45000000,Action,8305970,Johnny English Reborn,101,6.3,95736,-36694030
5579,40000000,Action,29121498,The Mechanic,93,6.6,131571,-10878502
5580,12500000,Drama,40962534,The Ides of March,101,7.1,198569,28462534
5581,15000000,Comedy,44671682,The Artist,100,7.9,202820,29671682
5582,35000000,Biography,37306030,J. Edgar,137,6.6,108929,2306030
5583,70000000,Action,83552429,Battle Los Angeles,116,5.8,160672,13552429
5584,0,Drama,1429260,The Art of Getting By,83,6.6,49820,1429260
5585,3500000,Drama,5354039,Margin Call,107,7.1,99567,1854039
5586,30000000,Comedy,18298649,Fright Night,106,6.4,89412,-11701351
5587,90000000,Animation,143619809,Rio,96,6.9,177152,53619809
5588,0,Crime,1196752,Headhunters,96,7.6,85380,1196752
5589,110000000,Animation,142614158,The Smurfs,100,5.5,71925,32614158
5590,250000,Drama,3413908,Like Crazy,86,6.7,51491,3163908
5591,13000000,Action,1024175,Attack the Block,88,6.6,87579,-11975825
5592,5000000,Drama,1729969,Take Shelter,121,7.4,76102,-3270031
5593,30000000,Action,63686397,Unknown,113,6.9,221649,33686397
5594,17000000,Drama,27865571,Beastly,86,5.6,68242,10865571
5595,40000000,Horror,42587643,Final Destination 5,92,5.9,89887,2587643
5596,0,Biography,14600347,My Week with Marilyn,99,7.0,75373,14600347
5597,150000000,Animation,165249063,Kung Fu Panda 2,90,7.3,203107,15249063
5598,4000000,Action,1104682,Red State,88,6.2,56365,-2895318
5599,100000,Drama,1316074,Another Earth,92,7.0,78957,1216074
5600,57000000,Action,51774002,Ghost Rider: Spirit of Vengeance,96,4.3,94617,-5225998
5601,42000000,Fantasy,37662162,Red Riding Hood,100,5.4,96451,-4337838
5602,16000000,Drama,37300107,The Roommate,100,4.9,30941,21300107
5603,38000000,Drama,58709717,Water for Elephants,100,6.9,100146,20709717
5604,0,Comedy,30538669,The Sitter,81,5.7,62890,30538669
5605,23000000,Action,18942396,Agentes Secretos,93,5.8,75489,-4057604
5606,20000000,Comedy,14008193,What's Your Number?,106,6.1,63448,-5991807
5607,0,Drama,2959,Perfect Sense,92,7.1,46538,2959
5608,25000000,Action,10324441,Straw Dogs,110,5.8,28710,-14675559
5609,23000000,Comedy,6923891,Take Me Home Tonight,100,6.3,46068,-16076109
5610,75000000,Action,78046570,Tower Heist,104,6.2,116459,3046570
5611,50000000,Action,10706786,Drive Angry,104,5.4,85499,-39293214
5612,10000000,Comedy,46412041,The Best Exotic Marigold Hotel,124,7.3,80051,36412041
5613,0,Horror,122890,The Human Centipede II (Full Sequence),91,3.9,29249,122890
5614,55000000,Drama,21283440,Dream House,84,6.0,54803,-33716560
5615,56000000,Comedy,54544638,New Year's Eve,113,5.7,70914,-1455362
5616,30000000,Comedy,35608245,Larry Crowne,98,6.1,53606,5608245
5617,70000000,Action,25124986,Killer Elite,116,6.5,111398,-44875014
5618,37000000,Drama,33047633,The Rite,114,6.0,80181,-3952367
5619,27000000,Action,38538188,Spy Kids 4: All the Time in the World,100,3.6,17340,11538188
5620,0,Comedy,203373,10 Years,100,6.1,20229,203373
5621,20000000,Adventure,23186769,Princesa por accidente,100,5.8,35684,3186769
5622,0,Comedy,36000,The Inbetweeners Movie,97,6.8,68128,36000
5623,6000000,Comedy,5359774,The Guard,100,7.3,69465,-640226
5624,40000000,Adventure,31847881,Extremely Loud & Incredibly Close,129,6.9,87522,-8152119
5625,0,Biography,1357042,The Devil's Double,109,7.1,56126,1357042
5626,35000000,Comedy,39046489,Something Borrowed,100,5.9,51026,4046489
5627,0,Drama,2981638,Martha Marcy May Marlene,102,6.9,42844,2981638
5628,45000000,Comedy,13100042,The Rum Diary,120,6.2,90562,-31899958
5629,13000000,Biography,30017992,The Iron Lady,105,6.4,88841,17017992
5630,25000000,Comedy,2547047,¿Sabes quién viene?,80,7.2,103437,-22452953
5631,750000,Horror,77501,The Innkeepers,101,5.5,29002,-672499
5632,70000000,Comedy,48475290,The Dilemma,111,5.3,45768,-21524710
5633,28000000,Action,37053924,30 minutos o menos,83,6.1,82495,9053924
5634,120000000,Action,98780042,The Green Hornet,100,5.8,142094,-21219958
5635,35000000,Crime,16816,Trespass,91,5.3,36771,-34983184
5636,45000000,Adventure,88631237,The Muppets,100,7.1,78440,43631237
5637,30000000,Action,21426805,The Darkest Hour,89,4.9,51758,-8573195
5638,40000000,Action,24827228,Season of the Witch,95,5.4,80353,-15172772
5639,36000000,Animation,99967670,Gnomeo & Juliet,84,6.0,45274,63967670
5640,12000000,Biography,1187711,Kill the Irishman,106,7.1,37684,-10812289
5641,0,Drama,455459,Weekend,97,7.7,22381,455459
5642,15000000,Drama,583455,W.E.,119,6.2,10495,-14416545
5643,5000000,Biography,9203192,Bernie,99,6.8,49922,4203192
5644,25000000,Action,19490041,The Eagle,114,6.2,57242,-5509959
5645,30000000,Action,538690,Machine Gun Preacher,129,6.8,56603,-29461310
5646,2000000,Drama,12555230,Silent House,86,5.3,19546,10555230
5647,79000000,Comedy,74158157,Jack and Jill,91,3.4,65046,-4841843
5648,17000000,Action,41081,Seeking Justice,105,6.2,40833,-16958919
5649,0,Comedy,70931,Butter,100,6.2,18293,70931
5650,130000000,Animation,149260504,Puss in Boots,90,6.7,122582,19260504
5651,12000000,Comedy,16311571,Young Adult,94,6.3,68120,4311571
5652,0,Comedy,1800000,Hysteria,100,6.7,27231,1800000
5653,0,Drama,756452,Coriolanus,123,6.2,28230,756452
5654,0,Drama,71177,Detachment,98,7.7,63058,71177
5655,63000000,Animation,108085305,Hop,100,5.5,26043,45085305
5656,25000000,Horror,18872522,Shark Night 3D,90,4.0,21890,-6127478
5657,37000000,Drama,72286779,Dolphin Tale,113,6.9,19114,35286779
5658,0,Comedy,142242,This Must Be the Place,118,6.7,28083,142242
5659,80000000,Comedy,80360843,Zookeeper,100,5.2,48201,360843
5660,21000000,Drama,970816,The Beaver,91,6.7,42609,-20029184
5661,0,Crime,26297,Kill List,95,6.4,29136,26297
5662,55000000,Comedy,68224452,Mr. Popper's Penguins,100,6.0,73019,13224452
5663,30000000,Drama,4463292,Anonymous,130,6.9,36079,-25536708
5664,94000000,Drama,9213,The Flowers of War,146,7.6,41876,-93990787
5665,3000000,Drama,22000,Aislados,112,5.8,31955,-2978000
5666,12000000,Crime,969239,Rampart,108,5.8,20869,-11030761
5667,21000000,Comedy,52698535,Diary of a Wimpy Kid: Rodrick Rules,100,6.6,20904,31698535
5668,0,Comedy,154604,A Good Old Fashioned Orgy,95,6.2,18896,154604
5669,0,Drama,96889,Wuthering Heights,129,6.1,7758,96889
5670,30000000,Animation,26692846,Winnie the Pooh,100,7.2,16941,-3307154
5671,0,Comedy,1201,Chalet Girl,100,6.3,20389,1201
5672,0,Adventure,3076226,Zindagi Na Milegi Dobara,155,8.1,50511,3076226
5673,3000000,Action,703002,Hobo with a Shotgun,86,6.1,39392,-2296998
5674,135000000,Animation,64006466,Happy Feet Two,100,5.9,34974,-70993534
5675,30000000,Adventure,23070045,Sanctum,108,5.9,49065,-6929955
5676,5000000,Horror,104007828,Paranormal Activity 3,83,5.8,80871,99007828
5677,0,Drama,1124786,The Deep Blue Sea,98,6.3,12608,1124786
5678,0,Comedy,539896,"Peace, Love, & Misunderstanding",96,5.9,6655,539896
5679,0,Comedy,9025107,Salmon Fishing in the Yemen,107,6.8,54890,9025107
5680,10000000,Comedy,7250054,Friends with Kids,107,6.2,37719,-2749946
5681,5000000,Comedy,24814830,Our Idiot Brother,90,6.4,77870,19814830
5682,19000000,Adventure,35033759,A Very Harold & Kumar 3D Christmas,90,6.3,58470,16033759
5683,14000000,Drama,46495,Margaret,150,6.5,13729,-13953505
5684,8000000,Drama,3014696,Albert Nobbs,113,6.7,20844,-4985304
5685,0,Comedy,122029,God Bless America,105,7.2,63198,122029
5686,0,Comedy,1237514,Take This Waltz,116,6.6,24105,1237514
5687,5000000,Horror,17686929,Apollo 18,86,5.2,49108,12686929
5688,0,Biography,67071,Puncture,100,6.9,20277,67071
5689,7000000,Action,1887,Catch .44,94,4.6,15243,-6998113
5690,75000000,Animation,133110742,Alvin and the Chipmunks: Chipwrecked,87,4.4,24939,58110742
5691,2000000,Biography,8012,The Snowtown Murders,119,6.6,14476,-1991988
5692,0,Adventure,176432,The Hunter,102,6.8,32746,176432
5693,0,Drama,19327,House of Tolerance,122,6.8,4868,19327
5694,0,Comedy,15374,Take Me Home,97,6.9,6434,15374
5695,40000000,Comedy,33035397,Arthur,110,5.7,47103,-6964603
5696,2000000,Drama,34522221,Courageous,100,7.0,16417,32522221
5697,41000000,Comedy,7204138,The Big Year,100,6.2,36943,-33795862
5698,0,Comedy,6857503,Cedar Rapids,87,6.3,33701,6857503
5699,0,Comedy,542,The Decoy Bride,89,6.2,9018,542
5700,0,Comedy,10011,A Little Bit of Heaven,100,6.3,24736,10011
5701,0,Drama,405614,Sound of My Voice,100,6.7,17812,405614
5702,8000000,Comedy,10130219,Prom,104,5.4,13474,2130219
5703,0,Drama,5981,Alps: Los suplantadores,100,6.4,5996,5981
5704,0,Crime,45282,Texas Killing Fields,105,5.7,16018,45282
5705,13000000,Drama,303877,In the Land of Blood and Honey,100,4.4,32055,-12696123
5706,10000000,Drama,5176,The Ledge,100,6.6,16604,-9994824
5707,0,Crime,151840,Bullhead,129,7.4,19152,151840
5708,0,Drama,99603,360,110,6.2,14114,99603
5709,10920000,Drama,985912,Rockstar,159,7.6,29940,-9934088
5710,20000000,Drama,4752353,Atlas Shrugged: Part I,97,5.7,11831,-15247647
5711,5000000,Comedy,1098,Flypaper,87,6.4,28775,-4998902
5712,13000000,Fantasy,69136,Intruders,100,5.4,18528,-12930864
5713,6600000,Comedy,37295394,Jumping the Broom,100,5.7,8399,30695394
5714,22000000,Animation,1002895,From Up on Poppy Hill,91,7.5,22336,-20997105
5715,32000000,Action,37915414,"Big Mommas: Like Father, Like Son",107,4.4,21446,5915414
5716,0,Drama,157427,Elles,99,5.7,5354,157427
5717,16700000,Action,3680306,Don 2,148,7.1,43225,-13019694
5718,8000000,Action,17186,Violet & Daisy,88,6.1,10028,-7982814
5719,0,Drama,27578,North Sea Texas,94,7.2,6494,27578
5720,250000000,Action,448139099,The Dark Knight Rises,164,8.4,1253772,198139099
5721,100000000,Drama,162805434,Django Unchained,165,8.4,1070691,62805434
5722,78000000,Adventure,408010692,The Hunger Games,142,7.2,748581,330010692
5723,220000000,Action,623357910,The Avengers,143,8.1,1064633,403357910
5724,130000000,Adventure,126477084,Prometheus,124,7.0,503113,-3522916
5725,180000000,Adventure,303003568,The Hobbit: An Unexpected Journey,169,7.9,680250,123003568
5726,17000000,Comedy,65001093,Pitch Perfect,112,7.2,231932,48001093
5727,60000000,Action,80070736,Jack Reacher,130,7.0,257474,20070736
5728,13000000,Drama,17738570,The Perks of Being a Wallflower,102,8.0,386932,4738570
5729,102000000,Action,27108272,Cloud Atlas,172,7.5,305013,-74891728
5730,120000000,Adventure,292298923,The Twilight Saga: Breaking Dawn - Part 2,115,5.5,197849,172298923
5731,30000000,Horror,42073277,The Cabin in the Woods,95,7.0,304144,12073277
5732,61000000,Drama,148809770,Les Misérables,158,7.6,262187,87809770
5733,16000000,Adventure,45512466,Moonrise Kingdom,94,7.8,261362,29512466
5734,200000000,Action,304360277,Skyfall,143,7.8,556275,104360277
5735,42000000,Action,138447667,21 Jump Street,110,7.2,441919,96447667
5736,209000000,Action,65422625,Battleship,131,5.8,213632,-143577375
5737,30000000,Action,66486205,Looper,113,7.4,461775,36486205
5738,40000000,Drama,95720716,Zero Dark Thirty,157,7.4,231134,55720716
5739,170000000,Action,155332381,Snow White and the Huntsman,127,6.1,243327,-14667619
5740,21000000,Comedy,132092958,Silver Linings Playbook,122,7.8,575513,111092958
5741,50000000,Comedy,57011521,American Reunion,113,6.7,181067,7011521
5742,150000000,Comedy,79727149,Dark Shadows,113,6.2,213561,-70272851
5743,0,Drama,12816367,Anna Karenina,129,6.6,77083,12816367
5744,230000000,Action,262030663,The Amazing Spider-Man,136,7.0,484931,32030663
5745,15000000,Crime,21383298,The Place Beyond the Pines,140,7.3,205530,6383298
5746,44500000,Adventure,136025503,Argo,120,7.7,491286,91525503
5747,3800000,Drama,687185,The Hunt,115,8.3,201299,-3112815
5748,7000000,Comedy,113721571,Magic Mike,110,6.1,115818,106721571
5749,125000000,Action,113203870,The Bourne Legacy,135,6.7,250175,-11796130
5750,45000000,Drama,19019882,The Impossible,114,7.6,160833,-25980118
5751,5000000,Crime,14123773,Spring Breakers,94,5.3,116309,9123773
5752,165000000,Animation,189422889,Wreck-It Ralph,101,7.7,298207,24422889
5753,185000000,Animation,237283207,Brave,93,7.2,302017,52283207
5754,35000000,Action,13414714,Dredd,95,7.1,218179,-21585286
5755,26000000,Crime,37400127,Lawless,116,7.3,199327,11400127
5756,3000000,Horror,48086903,Sinister,110,6.8,177787,45086903
5757,250000000,Action,73078100,John Carter,132,6.6,224234,-176921900
5758,65000000,Biography,182207973,Lincoln,150,7.4,211227,117207973
5759,75000000,Comedy,38518613,Rock of Ages,123,5.9,65550,-36481387
5760,225000000,Action,179020854,Men in Black 3,100,6.8,282995,-45979146
5761,31000000,Drama,93772375,Flight,138,7.3,280858,62772375
5762,50000000,Comedy,218815487,Ted,106,7.0,503464,168815487
5763,32000000,Drama,16377274,The Master,144,7.1,116047,-15622726
5764,7000000,Action,41003371,End of Watch,109,7.7,196450,34003371
5765,120000000,Adventure,124987023,Life of Pi,127,7.9,482766,4987023
5766,85000000,Animation,148313048,Hotel Transylvania,91,7.1,180944,63313048
5767,65000000,Action,54760791,This Means War,97,6.3,157282,-10239209
5768,70000000,Comedy,36931089,That's My Boy,116,5.6,76035,-33068911
5769,30000000,Drama,125014030,The Vow,104,6.8,159841,95014030
5770,12000000,Comedy,54731865,Project X,88,6.7,166912,42731865
5771,125000000,Action,58877969,Total Recall,118,6.3,214699,-66122031
5772,45000000,Crime,47382068,Savages,131,6.5,109373,2382068
5773,65000000,Comedy,59650222,The Dictator,83,6.4,230068,-5349778
5774,15000000,Comedy,15024049,Seven Psychopaths,110,7.2,200857,24049
5775,2000000,Comedy,17061,The First Time,95,6.9,55742,-1982939
5776,35000000,Comedy,67544505,This Is 40,134,6.2,109844,32544505
5777,25000000,Drama,60457138,The Lucky One,101,6.5,85269,35457138
5778,145000000,Animation,103412758,Rise of the Guardians,97,7.3,133291,-41587242
5779,150000000,Action,83670083,Furia de Titanes 2,99,5.8,161836,-66329917
5780,79000000,Action,103860290,Journey 2: The Mysterious Island,94,5.8,73718,24860290
5781,20000000,Adventure,17529157,Terror en Silent Hill 2: la revelación,95,5.0,53080,-2470843
5782,85000000,Action,126373434,Protegiendo al enemigo,115,6.8,177666,41373434
5783,8000000,Comedy,2540106,Ruby Sparks,100,7.2,84963,-5459894
5784,10000000,Drama,21590086,Mud,130,7.4,146045,11590086
5785,70000000,Action,62321039,Underworld Awakening,88,6.4,129757,-7678961
5786,100000000,Action,85017401,The Expendables 2,103,6.6,261485,-14982599
5787,65000000,Action,42345531,Resident Evil: Retribution,95,5.4,116830,-22654469
5788,0,Comedy,78950,Stuck in Love,97,7.3,72452,78950
5789,40000000,Comedy,41152203,What to Expect When You're Expecting,110,5.7,61163,1152203
5790,45000000,Action,139854287,Búsqueda implacable 2,92,6.3,254843,94854287
5791,3000000,Comedy,447954,Bachelorette,87,5.3,39857,-2552046
5792,12000000,Sci-Fi,64575175,Chronicle,89,7.1,216523,52575175
5793,17000000,Drama,54333290,The Woman in Black,95,6.4,153960,37333290
5794,30000000,Comedy,28835528,The Five-Year Engagement,124,6.2,83021,-1164472
5795,0,Horror,99770,V/H/S,116,5.8,48578,99770
5796,15000000,Action,15634090,The Man with the Iron Fists,95,5.4,55782,634090
5797,69000000,Action,37519139,Abraham Lincoln: Vampire Hunter,105,5.9,135188,-31480861
5798,20000000,Action,3749061,The Cold Light of Day,93,4.9,30822,-16250939
5799,6900000,Drama,31611916,House at the End of the Street,101,5.6,62147,24711916
5800,25000000,Adventure,717753,On the Road,124,6.1,35540,-24282247
5801,6000000,Drama,11494838,The Words,102,7.1,64718,5494838
5802,65000000,Action,44806783,Red Dawn,93,5.4,65454,-20193217
5803,10000000,Action,1939441,The Iceman,106,6.9,60121,-8060559
5804,70000000,Animation,214030500,The Lorax,86,6.4,83314,144030500
5805,26000000,Crime,16008272,The Raven,110,6.4,76320,-9991728
5806,0,Drama,2061449,Rust and Bone,120,7.5,53846,2061449
5807,42000000,Action,18620000,Man on a Ledge,102,6.6,131006,-23380000
5808,6000000,Horror,20551,Maniac,89,6.1,29681,-5979449
5809,10000000,Adventure,6619173,Seeking a Friend for the End of the World,101,6.7,95050,-3380827
5810,11000000,Comedy,46500,LOL,97,4.3,47937,-10953500
5811,85000000,Adventure,64935167,Mirror Mirror,106,5.6,74728,-20064833
5812,0,Biography,1546761,A Royal Affair,137,7.6,37338,1546761
5813,20000000,Action,14326864,Lockout,95,6.1,85680,-5673136
5814,60000000,Animation,56003051,ParaNorman,92,7.0,79594,-3996949
5815,60000000,Drama,35763137,Trouble with the Curve,111,6.8,51704,-24236863
5816,0,Comedy,4063238,Frances Ha,86,7.4,50014,4063238
5817,40000000,Action,26414527,One for the Money,91,5.3,36211,-13585473
5818,15000000,Crime,15026056,Killing Them Softly,97,6.2,117806,26056
5819,95000000,Animation,161321843,Ice Age: Continental Drift,88,6.6,158545,66321843
5820,42000000,Action,45290318,Here Comes the Boom,105,6.4,77895,3290318
5821,0,Drama,52624,Red Lights,114,6.2,51697,52624
5822,5000000,Comedy,376512,Piranha 3DD,83,3.8,34111,-4623488
5823,30000000,Action,17142080,Safe,94,6.5,89887,-12857920
5824,12000000,Action,70012847,Act of Valor,110,6.5,60703,58012847
5825,2500000,Horror,1163508,The Lords of Salem,101,5.1,22611,-1336492
5826,0,Comedy,21660,The ABCs of Death,129,4.7,15544,21660
5827,0,Comedy,44338224,The Three Stooges,92,5.1,26808,44338224
5828,35000000,Action,304318,Stolen,96,5.5,39133,-34695682
5829,20000000,Mystery,91186,"Pasión, un asesinato perfecto",102,5.3,18303,-19908814
5830,25000000,Action,66528000,Contraband,109,6.5,106160,41528000
5831,12500000,Drama,692640,The Paperboy,107,5.8,30992,-11807360
5832,0,Comedy,17225675,Wanderlust,98,5.6,65388,17225675
5833,8900000,Drama,6739492,Amour,127,7.9,77023,-2160508
5834,14000000,Horror,49130154,The Possession,92,5.9,50230,35130154
5835,145000000,Animation,216391482,Madagascar 3: Europe's Most Wanted,100,6.9,130435,71391482
5836,39000000,Animation,35291068,Frankenweenie,87,7.0,81006,-3708932
5837,68000000,Action,35353000,The Watch,102,5.7,109650,-32647000
5838,0,Drama,586293,To the Wonder,112,5.9,23334,586293
5839,0,Comedy,16685867,To Rome with Love,112,6.3,73659,16685867
5840,12000000,Comedy,91547205,Think Like a Man,100,6.6,36989,79547205
5841,95000000,Comedy,86907746,The Campaign,85,6.1,112145,-8092254
5842,0,Drama,84293,Byzantium,118,6.5,34757,84293
5843,16000000,Comedy,12412386,People Like Us,100,7.1,36565,-3587614
5844,750000,Comedy,4010957,Safety Not Guaranteed,100,7.0,106586,3260957
5845,2500000,Drama,2760,About Cherry,98,4.8,8592,-2497240
5846,10000000,Horror,6842058,The Collection,82,6.1,38699,-3157942
5847,33000000,Drama,35074677,Step Up Revolution,99,6.5,48309,2074677
5848,10000000,Drama,7435950,Disconnect,115,7.6,65916,-2564050
5849,25000000,Comedy,51853450,The Odd Life of Timothy Green,105,6.6,40006,26853450
5850,270000,Biography,318622,Compliance,90,6.4,26600,48622
5851,16600000,Adventure,1517410,Kon-Tiki,118,7.2,38013,-15082590
5852,12000000,Drama,7918283,Arbitrage,107,6.6,44196,-4081717
5853,0,Biography,6008677,Hitchcock,98,6.8,64089,6008677
5854,0,Drama,11653123,Gone,100,5.9,36704,11653123
5855,60000000,Drama,102118,Upside Down,109,6.4,62401,-59897882
5856,35000000,Action,20275446,Premium Rush,91,6.5,100314,-14724554
5857,0,Comedy,1059239,Thanks for Sharing,112,6.4,22269,1059239
5858,55000000,Action,9483821,Bullet to the Head,92,5.7,41677,-45516179
5859,0,Comedy,317190,Liberal Arts,97,6.7,31570,317190
5860,0,Drama,175058,El círculo roto,111,7.8,32959,175058
5861,12000000,Crime,65804,Deadfall,95,6.3,34374,-11934196
5862,0,Comedy,1378426,Girl Most Likely,103,5.8,13157,1378426
5863,0,Comedy,3094687,Celeste & Jesse Forever,100,6.6,25966,3094687
5864,35000000,Action,25888412,Alex Cross,101,5.1,29622,-9111588
5865,1000000,Biography,6002451,The Sessions,95,7.2,38014,5002451
5866,1000000,Horror,18119640,Chernobyl Diaries,86,5.0,55671,17119640
5867,1800000,Adventure,12795746,Beasts of the Southern Wild,93,7.3,73864,10995746
5868,22000000,Comedy,49008662,Diary of a Wimpy Kid: Dog Days,94,6.3,17568,27008662
5869,12000000,Crime,1744,The Samaritan,90,5.6,8339,-11998256
5870,2000000,Drama,5132442,The Company You Keep,125,6.4,27858,3132442
5871,0,Drama,258656,Great Expectations,128,6.4,10421,258656
5872,20500000,Drama,743636,Cosmópolis,109,5.0,39663,-19756364
5873,2000000,Action,13746550,Hit and Run,100,6.1,30897,11746550
5874,58000000,Action,49876377,Red Tails,100,5.9,30097,-8123623
5875,0,Drama,14947,Twice Born,127,7.4,13094,14947
5876,15000000,Comedy,3301046,Stand Up Guys,100,6.5,47799,-11698954
5877,35000000,Comedy,13101142,Playing for Keeps,105,5.7,25725,-21898858
5878,0,Comedy,141307,John Dies at the End,99,6.4,32210,141307
5879,20000000,Biography,6002756,Chasing Mavericks,100,7.2,27057,-13997244
5880,0,Drama,87910,Starlet,103,6.8,5294,87910
5881,2500000,Comedy,3325638,Robot & Frank,89,7.1,55671,825638
5882,40000000,Biography,20113965,Big Miracle,107,6.5,16132,-19886035
5883,0,Comedy,4327763,Much Ado About Nothing,109,7.2,14679,4327763
5884,15000000,Drama,7597898,Promised Land,100,6.6,32248,-7402102
5885,2900000,Horror,72140,No One Lives,86,6.0,14844,-2827860
5886,14000000,Adventure,9402410,Fun Size,86,5.4,12027,-4597590
5887,0,Comedy,354244,En la casa,105,7.4,24809,354244
5888,5000000,Horror,53921300,Paranormal Activity 4,88,4.6,54344,48921300
5889,55000000,Animation,31051126,The Pirates! Band of Misfits,88,6.7,38842,-23948874
5890,30000000,Comedy,63536011,Hope Springs,100,6.3,36501,33536011
5891,750000,Horror,53261944,The Devil Inside,83,4.2,31857,52511944
5892,0,Horror,30474,The Bay,84,5.6,21608,30474
5893,6000000,Drama,1065000,What Maisie Knew,93,7.5,23509,-4935000
5894,25000000,Comedy,77267296,Parental Guidance,105,6.1,22401,52267296
5895,850000,Comedy,1243961,"For a Good Time, Call...",88,6.0,14242,393961
5896,0,Drama,119919,Bel Ami,102,5.4,16219,119919
5897,11000000,Comedy,18390117,Quartet,94,6.8,16807,7390117
5898,40000000,Comedy,37134215,The Guilt Trip,95,5.8,32039,-2865785
5899,11500000,Action,5460,Universal Soldier: Day of Reckoning,114,5.0,17118,-11494540
5900,40000000,Comedy,18438149,A Thousand Words,91,5.9,33384,-21561851
5901,0,Comedy,100910,The Magic of Belle Isle,109,7.0,14538,100910
5902,6000000,Comedy,5895238,Casa de mi Padre,100,5.5,18126,-104762
5903,25000000,Comedy,30920167,Joyful Noise,100,5.7,7044,5920167
5904,16000000,Comedy,2964,Vamps,92,5.1,8112,-15997036
5905,0,Comedy,1631306,Todo lo que necesitas es amor,116,6.6,11049,1631306
5906,0,Action,26345,The Sweeney,112,6.1,17275,26345
5907,500000,Drama,375981,Smashed,81,6.8,14537,-124019
5908,17000000,Horror,4930798,The Apparition,83,4.1,17172,-12069202
5909,26350000,Comedy,20998,Lay the Favorite,94,4.8,9388,-26329002
5910,0,Biography,2291047,Renoir,111,6.6,4240,2291047
5911,0,Adventure,35722,Sightseers,88,6.5,22742,35722
5912,0,Comedy,304357,The Angels' Share,101,7.0,19767,304357
5913,0,Drama,1035953,Kahaani,122,8.2,45452,1035953
5914,0,Comedy,9222,If I Were You,115,7.0,1410,9222
5915,0,Drama,968879,Lore,109,7.1,12257,968879
5916,0,Drama,99134,Shadow Dancer,101,6.2,10685,99134
5917,0,Action,547,Into the White,104,7.2,16609,547
5918,20000000,Comedy,65653242,Madea's Witness Protection,100,4.9,7957,45653242
5919,0,Drama,1005700,Ginger & Rosa,90,6.3,8755,1005700
5920,0,Drama,519535,The Reluctant Fundamentalist,130,6.9,11537,519535
5921,0,Comedy,1347578,La bicicleta verde,98,7.6,14903,1347578
5922,6400000,Horror,8973,[REC] 3: Genesis,80,5.0,28103,-6391027
5923,0,Drama,379791,At Any Price,105,5.7,6237,379791
5924,7395080,Crime,2706375,Talaash,140,7.3,32323,-4688705
5925,0,Horror,8139,Dracula 3D,110,3.6,3321,8139
5926,0,Drama,526322,Being Flynn,100,6.4,14873,526322
5927,3000000,Horror,2034,ATM,90,4.7,20140,-2997966
5928,0,Drama,2343664,No,118,7.4,19935,2343664
5929,20000000,Drama,607327,Not Fade Away,100,6.0,3860,-19392673
5930,0,Comedy,3755,Save the Date,97,5.8,6241,3755
5931,0,Comedy,1670773,English Vinglish,134,7.9,25931,1670773
5932,3000000,Comedy,200803,Tim and Eric's Billion Dollar Movie,93,5.3,8478,-2799197
5933,2000000,Action,40179,Aftershock,89,4.8,9333,-1959821
5934,0,Drama,72100,"Farewell, My Queen",100,6.3,6728,72100
5935,0,Comedy,22930,Struck by Lightning,90,6.3,13513,22930
5936,0,Drama,413276,A Hijacking,103,7.2,13530,413276
5937,0,Biography,6367780,Hyde Park on Hudson,94,5.9,9985,6367780
5938,7980000,Comedy,1027121,Cocktail,146,6.2,10931,-6952879
5939,0,Drama,1561577,A Late Quartet,105,7.1,12008,1561577
5940,100000000,Biography,116900694,The Wolf of Wall Street,180,8.2,895552,16900694
5941,20000000,Horror,137400141,The Conjuring,112,7.5,342870,117400141
5942,46000000,Crime,61002302,Prisoners,153,8.1,449489,15002302
5943,150000000,Animation,400738009,Frozen,102,7.5,464149,250738009
5944,75000000,Crime,117723989,Now You See Me,115,7.3,505432,42723989
5945,20000000,Horror,71628180,Mamá,100,6.2,146508,51628180
5946,23000000,Drama,25568251,Her,126,8.0,404796,2568251
5947,225000000,Action,291045518,Man of Steel,143,7.1,590734,66045518
5948,37000000,Comedy,150394119,We're the Millers,110,7.0,342500,113394119
5949,105000000,Drama,144840419,El gran Gatsby,143,7.3,394723,39840419
5950,0,Drama,2199675,Blue Is the Warmest Color,180,7.8,107119,2199675
5951,0,Drama,785669,Ninfomanía: primera parte,117,7.0,93710,785669
5952,190000000,Action,101802906,Pacific Rim,131,7.0,407588,-88197094
5953,0,Mystery,1007088,Enemigos idénticos,91,6.9,117920,1007088
5954,130000000,Action,424668047,The Hunger Games: Catching Fire,146,7.6,535963,294668047
5955,40000000,Crime,150117807,American Hustle,138,7.3,386428,110117807
5956,100000000,Drama,274092705,Gravity,91,7.8,638007,174092705
5957,20000000,Biography,56671993,12 Years a Slave,134,8.1,503763,36671993
5958,190000000,Action,228778661,Star Trek Into Darkness,132,7.8,423966,38778661
5959,200000000,Action,409013994,Iron Man 3,130,7.2,605330,209013994
5960,70000000,Action,98925640,Olympus Has Fallen,119,6.5,218879,28925640
5961,120000000,Action,89021735,Oblivion,124,7.0,418811,-30978265
5962,5000000,Biography,27298285,Dallas Buyers Club,117,8.0,362192,22298285
5963,12000000,Comedy,15322921,About Time,123,7.8,228554,3322921
5964,190000000,Action,202359711,World War Z,116,7.0,507319,12359711
5965,60000000,Action,46000903,Gangster Squad,113,6.7,184266,-13999097
5966,40000000,Action,125095601,Lone Survivor,121,7.5,224829,85095601
5967,30000000,Drama,35266619,Carrie,100,5.9,115826,5266619
5968,170000000,Action,206362140,Thor: The Dark World,112,7.0,456007,36362140
5969,38000000,Action,26947624,Rush,123,8.1,349811,-11052376
5970,32000000,Comedy,101470202,This Is the End,107,6.6,334845,69470202
5971,39200000,Action,4563650,El expreso del miedo,126,7.0,207368,-34636350
5972,3000000,Horror,64473115,La noche de la expiación,85,5.7,159252,61473115
5973,160000000,Action,238679850,Fast & Furious 6,130,7.1,324918,78679850
5974,6000000,Adventure,7192291,The Green Inferno,100,5.3,28341,1192291
5975,80000000,Comedy,133668525,Grown Ups 2,101,5.4,117428,53668525
5976,28000000,Action,28795985,Kick-Ass 2,103,6.6,219877,795985
5977,225000000,Adventure,258366855,The Hobbit: The Desolation of Smaug,161,7.9,524571,33366855
5978,60000000,Drama,19452138,Beautiful Creatures,124,6.2,73570,-40547862
5979,25000000,Crime,16973715,The Counsellor,117,5.3,86494,-8026285
5980,17000000,Fantasy,54239856,Evil Dead,91,6.5,135944,37239856
5981,90000000,Adventure,58236838,The Secret Life of Walter Mitty,114,7.3,255109,-31763162
5982,115000000,Action,93050117,Elysium,109,6.6,366674,-21949883
5983,20000000,Action,26004851,The World's End,109,7.0,207634,6004851
5984,43000000,Action,159582188,The Heat,117,6.6,142704,116582188
5985,30000000,Comedy,36918811,The Family,111,6.3,95229,6918811
5986,13300000,Drama,2605039,Under the Skin,108,6.3,98496,-10694961
5987,76000000,Animation,368061265,Despicable Me 2,98,7.4,314045,292061265
5988,3000000,Comedy,24477704,Don Jon,90,6.6,203473,21477704
5989,60000000,Action,31165421,The Mortal Instruments: City of Bones,130,5.9,114481,-28834579
5990,30000000,Action,2162593,Old Boy,104,5.8,56204,-27837407
5991,50000000,Action,55703475,Hansel y Gretel: Cazadores de brujas,88,6.1,170882,5703475
5992,28000000,Drama,71349120,Safe Haven,115,6.7,87269,43349120
5993,130000000,Action,122523060,G.I. Joe: Retaliation,110,5.8,154740,-7476940
5994,6000000,Comedy,8828771,Movie 43,94,4.3,85609,2828771
5995,0,Drama,326983,Ninfomanía: segunda parte,123,6.7,68336,326983
5996,50000000,Action,25132228,Escape Plan,115,6.7,192466,-24867772
5997,110000000,Action,61737191,Ender's Game,114,6.7,197592,-48262809
5998,22000000,Crime,11326836,Out of the Furnace,116,6.8,90855,-10673164
5999,5000000,Horror,27695246,Oculus,104,6.5,95687,22695246
6000,26000000,Action,49875291,Pain & Gain,129,6.5,172482,23875291
6001,12000000,Drama,1702277,Stoker,99,6.8,90922,-10297723
6002,135000000,Animation,187168425,The Croods,98,7.2,163313,52168425
6003,45000000,Action,12050299,The Last Stand,107,6.4,120452,-32949701
6004,50000,Mystery,68877,Coherence,89,7.2,71677,18877
6005,120000000,Action,132556852,The Wolverine,126,6.7,364907,12556852
6006,35000000,Comedy,66380662,Warm Bodies,98,6.9,196631,31380662
6007,20000000,Horror,34341945,Texas Chainsaw 3D,92,4.8,38083,14341945
6008,55000000,Biography,107100855,Captain Phillips,134,7.8,354410,52100855
6009,2500000,Comedy,6851969,The Spectacular Now,95,7.1,119642,4351969
6010,103000000,Comedy,112200072,The Hangover Part III,100,5.9,245488,9200072
6011,58000000,Comedy,44672764,The Internship,119,6.3,169189,-13327236
6012,0,Drama,164480,Horns,120,6.5,63156,164480
6013,215000000,Action,89302115,The Lone Ranger,150,6.5,194951,-125697885
6014,215000000,Adventure,234911825,Oz the Great and Powerful,130,6.3,183680,19911825
6015,16000000,Drama,317125,Adore,100,6.2,26214,-15682875
6016,200000000,Animation,268492764,Monsters University,104,7.3,258992,68492764
6017,4800000,Crime,778565,Sólo Dios perdona,90,5.7,91897,-4021435
6018,150000000,Action,73103784,White House Down,131,6.4,176922,-76896216
6019,11000000,Comedy,3452117,What If,98,6.8,57422,-7547883
6020,0,Crime,85433,The Best Offer,131,7.8,81409,85433
6021,5000000,Horror,83586447,Insidious: Chapter 2,106,6.6,123320,78586447
6022,30000000,Crime,32172757,Side Effects,106,7.1,157546,2172757
6023,90000000,Adventure,68559554,Percy Jackson: Sea of Monsters,106,5.9,93908,-21440446
6024,0,Drama,1361423,Locke,85,7.1,104599,1361423
6025,84000000,Action,53262560,RED 2,116,6.7,136471,-30737440
6026,8000000,Comedy,16170632,Begin Again,104,7.4,115851,8170632
6027,38000000,Action,42025135,Riddick,119,6.4,134609,4025135
6028,40000000,Action,26627201,The Host,125,5.9,98678,-13372799
6029,5000000,Comedy,34321,Filth,97,7.1,84261,-4965679
6030,40000000,Biography,95001343,42,128,7.5,71006,55001343
6031,92000000,Action,67349198,A Good Day to Die Hard,98,5.3,175817,-24650802
6032,130000000,Action,60522097,After Earth,100,4.9,169422,-69477903
6033,5000000,Comedy,21501098,The Way Way Back,103,7.4,124197,16501098
6034,175000000,Action,38362475,47 Ronin,119,6.3,125778,-136637525
6035,18000000,Drama,33405481,Blue Jasmine,98,7.3,164208,15405481
6036,30000000,Biography,116632095,Lee Daniels' The Butler,132,7.2,94884,86632095
6037,22000000,Action,19783777,Homefront,100,6.5,90430,-2216223
6038,25000000,Drama,37738503,August: Osage County,121,7.2,73438,12738503
6039,195000000,Adventure,65187603,Jack the Giant Slayer,114,6.3,113861,-129812397
6040,130000000,Action,33618855,R.I.P.D.,100,5.6,99230,-96381145
6041,13000000,Comedy,25682380,21 & Over,93,5.9,64737,12682380
6042,30000000,Action,10880926,Dead Man Down,118,6.5,57854,-19119074
6043,11000000,Drama,13235319,Inside Llewyn Davis,104,7.5,109079,2235319
6044,0,Drama,2852400,The Great Beauty,141,7.8,63499,2852400
6045,20000000,Action,8008161,Machete Kills,107,5.6,64085,-11991839
6046,7000000,Comedy,1879534,Sólo los amantes sobreviven,123,7.3,70934,-5120466
6047,35000000,Biography,83301580,Saving Mr. Banks,125,7.5,128240,48301580
6048,35000000,Comedy,134506920,Identity Thief,111,5.7,105070,99506920
6049,20000000,Crime,2319187,Trance,101,7.0,99164,-17680813
6050,61000000,Action,75612460,2 Guns,109,6.7,168840,14612460
6051,0,Drama,48022,Young & Beautiful,95,6.8,25415,48022
6052,0,Comedy,32514,I Give It a Year,97,5.7,31956,32514
6053,12000000,Biography,16117443,Jobs,128,5.9,83258,4117443
6054,3000000,Drama,8114627,Before Midnight,109,7.9,108281,5114627
6055,15000000,Action,42930462,Snitch,112,6.5,69553,27930462
6056,10000000,Biography,356582,Lovelace,93,6.2,33357,-9643418
6057,8000000,Biography,5841046,The Bling Ring,90,5.6,72810,-2158954
6058,35000000,Comedy,21784432,The Big Wedding,100,5.6,40708,-13215568
6059,35000000,Action,17609982,Parker,118,6.2,97771,-17390018
6060,19000000,Drama,21488481,The Book Thief,131,7.6,108953,2488481
6061,50000000,Comedy,127352707,Anchorman 2: The Legend Continues,119,6.3,142452,77352707
6062,105000000,Animation,71017784,The Smurfs 2,105,5.4,30631,-33982216
6063,13000000,Crime,51872378,The Call,100,6.7,95726,38872378
6064,1066167,Crime,258113,Blue Ruin,90,7.1,51447,-808054
6065,0,Drama,1161089,Romeo & Juliet,113,5.8,9141,1161089
6066,0,Crime,441,I Spit on Your Grave 2,106,5.7,21070,441
6067,30000000,Adventure,22525921,The Incredible Burt Wonderstone,100,5.9,63722,-7474079
6068,0,Drama,1010414,Short Term 12,96,8.0,64478,1010414
6069,8500000,Comedy,219438,The Zero Theorem,107,6.1,38378,-8280562
6070,0,Adventure,1290312,The Kings of Summer,95,7.2,67276,1290312
6071,28000000,Comedy,63914167,Last Vegas,105,6.6,114125,35914167
6072,0,Comedy,342936,Drinking Buddies,90,6.1,49646,342936
6073,0,Drama,750100,Palo Alto,100,6.3,22964,750100
6074,10900000,Biography,10726630,Belle,100,7.4,23053,-173370
6075,0,Biography,1029949,Kill Your Darlings,104,6.5,29273,1029949
6076,0,Comedy,200268,The Double,93,6.5,39922,200268
6077,0,Drama,4105,Contracted,84,5.3,11798,4105
6078,20000000,Comedy,32015787,Scary Movie 5,88,3.5,54324,12015787
6079,0,Crime,387606,Ain't Them Bodies Saints,96,6.4,17678,387606
6080,12000000,Biography,37707719,Philomena,98,7.6,82660,25707719
6081,30000000,Crime,19316646,Runner Runner,88,5.6,55262,-10683354
6082,9000000,Action,6263670,All Is Lost,106,6.9,64524,-2736330
6083,12000000,Adventure,17654912,Nebraska,115,7.7,97893,5654912
6084,50000,Drama,444098,Upstream Color,96,6.7,25775,394098
6085,8000000,Comedy,17536788,Enough Said,93,7.1,52358,9536788
6086,28000000,Drama,1019038,Amores infieles,137,6.4,22766,-26980962
6087,100000000,Animation,107518682,Epic,102,6.7,90501,7518682
6088,26000000,Comedy,30664106,Delivery Man,105,6.4,65081,4664106
6089,1500000,Comedy,3447339,The To Do List,104,5.8,32105,1947339
6090,0,Drama,125687,Europa Report,97,6.5,58171,125687
6091,3500000,Horror,17411930,Dark Skies,97,6.3,61914,13911930
6092,18000000,Drama,13362308,Labor Day,111,6.9,35029,-4637692
6093,0,Horror,21833,V/H/S/2,96,6.1,30156,21833
6094,20000000,Action,34956,Redemption,100,6.2,56365,-19965044
6095,78000000,Animation,119793567,Cloudy with a Chance of Meatballs 2,95,6.4,71615,41793567
6096,250000,Drama,49494,The Canyons,99,3.9,9126,-200506
6097,30000000,Animation,5209580,Se levanta el viento,126,7.8,51601,-24790420
6098,28000000,Biography,3254172,The Fifth Estate,128,6.2,32623,-24745828
6099,35000000,Crime,19701164,Broken City,109,6.2,67526,-15298836
6100,16000000,Drama,2013456,The Immigrant,120,6.6,23805,-13986544
6101,900000,Biography,16097842,Fruitvale Station,85,7.5,59913,15197842
6102,18000000,Biography,4435083,Un pasado imborrable,116,7.1,31065,-13564917
6103,35000000,Drama,7376027,Paranoia,106,5.7,30891,-27623973
6104,40000000,Comedy,29807260,Grudge Match,113,6.4,50116,-10192740
6105,15000000,Biography,331634,Diana,113,5.5,16386,-14668366
6106,135000000,Animation,83028128,Turbo,96,6.5,67648,-51971872
6107,0,Comedy,2151202,Austenland,97,6.3,16374,2151202
6108,0,Comedy,16740,Adult World,97,6.2,14692,16740
6109,2500000,Comedy,40041683,A Haunted House,86,5.1,37158,37541683
6110,4000000,Horror,9039,The Sacrament,99,6.1,13644,-3990961
6111,0,Drama,60213,How I Live Now,101,6.5,23772,60213
6112,50000000,Animation,90288712,Planes,91,5.8,37338,40288712
6113,0,Drama,76633,We Are What We Are,105,5.9,16772,76633
6114,15000000,Comedy,102003019,Bad Grandpa,92,6.5,81683,87003019
6115,0,Comedy,174496,Afternoon Delight,98,5.8,8099,174496
6116,4000000,Drama,373375,Joe,117,6.9,39431,-3626625
6117,0,Action,27713,Killing Season,91,5.4,30687,27713
6118,0,Comedy,3763973,Fading Gigolo,90,6.2,20930,3763973
6119,3300000,Drama,1359563,Gimme Shelter,100,6.5,7082,-1940437
6120,0,Crime,34100,Starred Up,106,7.4,35739,34100
6121,0,Adventure,508806,Tracks,112,7.2,22475,508806
6122,0,Crime,420266,In Secret,107,6.1,6118,420266
6123,7000000,Drama,4288,Anna,99,6.5,16817,-6995712
6124,0,Comedy,1367846,I'm So Excited!,90,5.6,18657,1367846
6125,25000000,Action,100144,Man of Tai Chi,105,6.1,30477,-24899856
6126,6500000,Adventure,2268296,The East,116,6.8,44425,-4231704
6127,0,Drama,15324,Breathe In,98,6.4,11843,15324
6128,0,Comedy,7973,Charlie Countryman,103,6.4,23502,7973
6129,25500000,Crime,41229,Blood Ties,127,6.5,16156,-25458771
6130,0,Drama,342183,La piel de Venus,96,7.2,13764,342183
6131,0,Adventure,86796,Knights of Badassdom,100,5.7,17169,86796
6132,0,Drama,3827060,Ida,82,7.4,40046,3827060
6133,0,Adventure,1083762,The 100 Year-Old Man Who Climbed Out the Window and Disappeared,114,7.1,31110,1083762
6134,8500000,Action,6787,Welcome to the Punch,99,6.1,28765,-8493213
6135,5000000,Drama,40040,CBGB,101,6.6,7038,-4959960
6136,0,Comedy,518134,Dom Hemingway,93,6.2,22984,518134
6137,0,Adventure,1429534,Queen,146,8.3,48398,1429534
6138,0,Biography,1234254,The Invisible Woman,111,6.1,7911,1234254
6139,0,Comedy,59437,Zonas húmedas,109,5.8,9107,59437
6140,10000000,Drama,652355,Parkland,93,6.3,12682,-9347645
6141,0,Action,357000,Walking with the Enemy,124,6.0,884,357000
6142,5000000,Comedy,44467206,Instructions Not Included,115,7.6,24412,39467206
6143,1000000,Drama,4231500,The Lunchbox,104,7.8,36929,3231500
6144,0,Comedy,2962542,In a World...,100,6.7,27802,2962542
6145,0,Drama,38361,Concussion,96,5.7,3324,38361
6146,35000000,Biography,8323085,Mandela: Long Walk to Freedom,141,7.1,23075,-26676915
6147,0,Animation,1506975,The Tale of the Princess Kaguya,137,8.1,23571,1506975
6148,0,Drama,51975354,Temptation: Confessions of a Marriage Counselor,111,5.0,10473,51975354
6149,0,Horror,23838,The Last Days on Mars,98,5.5,31095,23838
6150,0,Action,18058,Journey to the West,110,6.8,9526,18058
6151,0,Biography,323032,Jimi: All Is by My Side,118,5.7,4984,323032
6152,38600000,Action,6594959,The Grandmaster,130,6.5,26489,-32005041
6153,17000000,Comedy,70525195,The Best Man Holiday,123,6.7,12301,53525195
6154,0,Action,2137,Pawn,88,5.7,6144,2137
6155,0,Comedy,61446,The Art of the Steal,90,6.3,20439,61446
6156,0,Animation,137815,The Congress,122,6.5,14289,137815
6157,30000000,Action,1013945,Stalingrad,131,5.6,13238,-28986055
6158,12000000,Comedy,261695,Life of Crime,98,5.8,14145,-11738305
6159,11000000,Drama,1330596,El pasado,130,7.8,37148,-9669404
6160,81000000,Action,128261724,Kingsman: The Secret Service,129,7.7,467659,47261724
6161,165000000,Adventure,188020017,Interstellar,169,8.6,1095553,23020017
6162,170000000,Action,333176600,Guardians of the Galaxy,121,8.1,791340,163176600
6163,15000000,Drama,25442958,Ex Machina,108,7.7,355666,10442958
6164,61000000,Crime,167767189,Gone Girl,149,8.1,660194,106767189
6165,20000000,Action,43037835,John Wick,101,7.3,355140,23037835
6166,25000000,Adventure,59100318,The Grand Budapest Hotel,99,8.1,550331,34100318
6167,3300000,Drama,13092000,Whiplash,107,8.5,503754,9792000
6168,34000000,Action,102427862,The Maze Runner,113,6.8,344991,68427862
6169,6500000,Horror,84273813,Annabelle,99,5.4,99635,77773813
6170,2000000,Horror,14673301,It Follows,100,6.9,147224,12673301
6171,85000000,Adventure,150947895,Divergent,139,6.7,370154,65947895
6172,14000000,Biography,91125683,The Imitation Game,114,8.0,547832,77125683
6173,170000000,Action,208545589,Dawn of the Planet of the Apes,130,7.6,355042,38545589
6174,178000000,Action,100206256,Edge of Tomorrow,113,7.9,486882,-77793744
6175,55000000,Action,101530738,The Equalizer,132,7.2,254915,46530738
6176,210000000,Action,245439076,Transformers: Age of Extinction,165,5.7,263822,35439076
6177,50000000,Action,191719337,22 Jump Street,112,7.1,288814,141719337
6178,68000000,Action,85817906,Fury,134,7.6,341512,17817906
6179,12000000,Drama,124872350,The Fault in Our Stars,126,7.8,280217,112872350
6180,18000000,Comedy,42340598,Birdman or (The Unexpected Virtue of Ignorance),119,7.8,455260,24340598
6181,8500000,Crime,32381218,Nightcrawler,118,7.9,347271,23881218
6182,200000000,Action,233921534,X-Men: Days of Future Past,132,8.0,565997,33921534
6183,2000000,Drama,924279,The Babadook,93,6.8,141407,-1075721
6184,58800000,Action,350126372,American Sniper,133,7.3,362949,291326372
6185,170000000,Action,259766572,Captain America: The Winter Soldier,136,7.8,559974,89766572
6186,60000000,Animation,257760692,The Lego Movie,100,7.8,274608,197760692
6187,1500000,Horror,55007,El payaso del mal,100,5.7,16279,-1444993
6188,40000000,Action,126663600,Lucy,89,6.4,363219,86663600
6189,200000000,Action,202853933,The Amazing Spider-Man 2,142,6.7,352313,2853933
6190,165000000,Animation,222527828,Big Hero 6,102,7.8,320396,57527828
6191,180000000,Action,241410378,Maleficent,97,7.0,275137,61410378
6192,125000000,Action,101200044,Noah,138,5.8,213644,-23799956
6193,15000000,Biography,35893537,The Theory of Everything,123,7.7,310187,20893537
6194,250000000,Adventure,255119788,The Hobbit: The Battle of the Five Armies,144,7.4,396797,5119788
6195,100000000,Action,72688614,Hercules,98,6.0,125393,-27311386
6196,80000000,Action,23219748,Pompeya,100,5.5,92503,-56780252
6197,125000000,Action,337135885,The Hunger Games: Mockingjay - Part 1,123,6.7,341715,212135885
6198,44000000,Comedy,6105175,The Interview,112,6.6,267070,-37894825
6199,90000000,Action,39322544,The Expendables 3,126,6.1,141488,-50677456
6200,3300000,Comedy,3107072,Relatos salvajes,122,8.1,118272,-192928
6201,25000000,Drama,45089048,El dador de recuerdos,97,6.5,96205,20089048
6202,1600000,Comedy,3333000,Entrevista con unos vampiros,86,7.6,90970,1733000
6203,110000000,Action,106580051,300: Rise of an Empire,102,6.2,242932,-3419949
6204,8000000,Drama,1410915,99 Homes,112,7.1,22416,-6589085
6205,0,Biography,1822030,Testament of Youth,129,7.3,19225,1822030
6206,0,Drama,68372,Predestination,97,7.5,195819,68372
6207,40000000,Comedy,83911193,The Other Woman,109,6.0,113167,43911193
6208,160000000,Action,200676069,Godzilla,123,6.4,323734,40676069
6209,50000000,Adventure,128002372,Into the Woods,125,6.0,112609,78002372
6210,11000000,Comedy,30640336,Chef,114,7.3,156375,19640336
6211,140000000,Action,65014513,Exodus: Gods and Kings,150,6.0,140323,-74985487
6212,0,Comedy,14893,Tal vez es para siempre,102,7.2,85099,14893
6213,40000000,Comedy,43139300,A Million Ways to Die in the West,116,6.1,147947,3139300
6214,65000000,Crime,13757804,Sin City: A Dame to Kill For,102,6.5,126091,-51242196
6215,70000000,Action,56280355,Dracula Untold,92,6.3,152210,-13719645
6216,65000000,Biography,115637895,Unbroken,137,7.2,117590,50637895
6217,95000000,Action,17223265,Seventh Son,102,5.5,61441,-77776735
6218,1000000,Drama,31537320,Unfriended,83,5.6,52922,30537320
6219,48000000,Action,89256424,Búsqueda implacable 3,109,6.0,149069,41256424
6220,40000000,Comedy,46294610,Blended,117,6.5,96218,6294610
6221,26000000,Drama,26761283,The Best of Me,118,6.7,51322,761283
6222,4000000,Drama,25379975,Boyhood,165,7.9,293068,21379975
6223,65000000,Comedy,85911262,Annie,118,5.3,28204,20911262
6224,40000000,Comedy,38543473,Sex Tape,94,5.1,92074,-1456527
6225,20000000,Comedy,8110975,Inherent Vice,148,6.7,72027,-11889025
6226,1000000,Horror,9168,Honeymoon,87,5.7,20262,-990832
6227,60000000,Action,50577412,Jack Ryan: Shadow Recruit,105,6.2,105471,-9422588
6228,15000000,Adventure,37880356,Wild,115,7.1,98839,22880356
6229,3000000,Comedy,1821983,Tusk,102,5.4,35556,-1178017
6230,66000000,Action,43577636,Need for Speed,132,6.5,145738,-22422364
6231,50000000,Animation,50151543,The Book of Life,95,7.3,51976,151543
6232,18000000,Comedy,150157400,Neighbors,97,6.3,242874,132157400
6233,100000000,Action,58607007,RoboCop,117,6.2,193792,-41392993
6234,127000000,Adventure,113746621,Night at the Museum: Secret of the Tomb,98,6.2,78239,-13253379
6235,12600000,Crime,10724389,The Drop,106,7.1,119833,-1875611
6236,11000000,Drama,50474843,If I Stay,107,6.8,95609,39474843
6237,145000000,Animation,177002924,How to Train Your Dragon 2,102,7.8,243596,32002924
6238,0,Comedy,37047,Before We Go,95,6.9,34243,37047
6239,5000000,Mystery,322600,The Guest,100,6.7,73747,-4677400
6240,125000000,Action,191204754,Teenage Mutant Ninja Turtles,101,5.8,181678,66204754
6241,70000000,Action,18848538,The Legend of Hercules,100,4.2,47597,-51151462
6242,30000000,Action,7791146,Vampire Academy,104,5.6,45199,-22208854
6243,100000000,Drama,23022309,Transcendence,119,6.3,189106,-76977691
6244,0,Drama,334658,I Origins,106,7.3,90264,334658
6245,24000000,Biography,12096300,Foxcatcher,134,7.0,117034,-11903700
6246,13000000,Comedy,44134898,St. Vincent,102,7.3,82653,31134898
6247,14000000,Mystery,5981749,El penthouse,108,6.3,40462,-8018251
6248,25000000,Crime,33631221,The Gambler,111,6.0,53990,8631221
6249,8000000,Comedy,26049082,That Awkward Moment,94,6.2,83613,18049082
6250,10000000,Biography,14479776,Big Eyes,106,7.0,66972,4479776
6251,9000000,Action,71962800,12 horas para sobrevivir,103,6.5,110032,62962800
6252,50000000,Action,92168600,Non-Stop,106,7.0,216312,42168600
6253,50000000,Action,47602194,Into the Storm,89,5.8,57376,-2397806
6254,50000000,Crime,47119388,The Judge,141,7.4,150371,-2880612
6255,35000000,Adventure,86208010,Dumb and Dumber To,109,5.7,107048,51208010
6256,0,Comedy,39751,Walk of Shame,95,6.0,44493,39751
6257,5000000,Horror,21197315,"As Above, So Below",93,6.2,57343,16197315
6258,17000000,Comedy,82390774,Let's Be Cops,104,6.5,114845,65390774
6259,42000000,Comedy,54445357,Horrible Bosses 2,108,6.3,129349,12445357
6260,20000000,Crime,5740310,A Most Violent Year,125,7.0,52607,-14259690
6261,19800000,Comedy,34290142,This Is Where I Leave You,103,6.6,59852,14490142
6262,30000000,Horror,30577122,Deliver Us from Evil,118,6.2,58772,577122
6263,60000000,Drama,22451,Winter's Tale,118,6.2,45005,-59977549
6264,22000000,Drama,2963012,Before I Go to Sleep,92,6.3,56415,-19036988
6265,20000000,Drama,23393765,Endless Love,104,6.3,34658,3393765
6266,16800000,Comedy,10506939,Magic in the Moonlight,97,6.6,53136,-6293061
6267,30000000,Drama,176305,Serena,109,5.4,20668,-29823695
6268,28000000,Action,30697999,3 Days to Kill,117,6.2,75138,2697999
6269,22000000,Comedy,54240821,The Hundred-Foot Journey,122,7.3,61319,32240821
6270,28000000,Crime,26307600,A Walk Among the Tombstones,114,6.5,95753,-1692400
6271,0,Drama,3492754,Mommy,139,8.1,35841,3492754
6272,0,Drama,139511,A Brilliant Young Mind,111,7.2,22615,139511
6273,5000000,Drama,18754371,Still Alice,101,7.5,101773,13754371
6274,70000000,Drama,78031620,The Monuments Men,118,6.1,109977,8031620
6275,0,Horror,1168902,Goodnight Mommy,99,6.7,29190,1168902
6276,0,Drama,551609,A Little Chaos,112,6.5,15294,551609
6277,4000000,Sci-Fi,600896,The Signal,97,6.1,53291,-3399104
6278,55000000,Animation,76223578,Paddington,95,7.2,56480,21223578
6279,7000000,Drama,1873547,Cake,102,6.4,30337,-5126453
6280,4500000,Action,2625803,The Raid 2,150,8.0,93993,-1874197
6281,5000000,Horror,50856010,Ouija,89,4.5,39099,45856010
6282,65000000,Action,19075290,"I, Frankenstein",92,5.1,70705,-45924710
6283,20000000,Biography,52076908,Selma,128,7.5,69760,32076908
6284,0,Comedy,88460,Enredos en Broadway,93,6.1,19802,88460
6285,0,Comedy,644906,Frank,95,7.0,62768,644906
6286,0,Comedy,1358561,Fuerza mayor,120,7.3,34232,1358561
6287,16000000,Drama,2428883,The Homesman,122,6.6,24489,-13571117
6288,19000000,Biography,2436062,Pawn Sacrifice,115,7.0,29268,-16563938
6289,0,Romance,506067,The Two Faces of January,96,6.2,24842,506067
6290,16000000,Action,13998282,Left Behind,110,3.1,28203,-2001718
6291,0,Comedy,8163,Zombeavers,77,4.8,12863,8163
6292,0,Comedy,15600,Two Night Stand,86,6.4,52628,15600
6293,15000000,Crime,17237244,A Most Wanted Man,122,6.8,62647,2237244
6294,0,Comedy,10616104,PK,153,8.2,111073,10616104
6295,0,Comedy,116400,5 to 7,95,7.1,13188,116400
6296,0,Drama,5000,La salvación,92,6.7,29077,5000
6297,0,Drama,80015,Heaven Knows What,97,6.5,2884,80015
6298,0,Adventure,1121961,Héctor y el secreto de la felicidad,120,7.0,37553,1121961
6299,10000000,Biography,12547189,Love & Mercy,121,7.4,28639,2547189
6300,132000000,Animation,83348920,Penguins of Madagascar,92,6.7,66287,-48651080
6301,0,Adventure,1171559,Black Sea,114,6.4,28336,1171559
6302,35000000,Action,10508518,Sabotage,109,5.7,51146,-24491482
6303,15000000,Comedy,347648,Mapa a las estrellas,111,6.2,31631,-14652352
6304,5000000,Biography,2450846,Kill the Messenger,112,7.0,36607,-2549154
6305,25000000,Drama,28831145,Draft Day,110,6.8,43430,3831145
6306,0,Drama,1092800,Leviathan,140,7.6,36668,1092800
6307,100000,Drama,511635,The One I Love,91,7.1,27078,411635
6308,16000000,Comedy,461162,"Men, Women & Children",119,6.7,25383,-15538838
6309,10000000,Comedy,7574066,While We're Young,97,6.3,35437,-2425934
6310,0,Comedy,55749,Cooties,88,5.7,17646,55749
6311,2000000,Drama,60755732,God's Not Dead,100,4.8,34760,58755732
6312,45000000,Drama,14904384,Step Up All In,112,6.0,27883,-30095616
6313,145000000,Animation,111506430,Mr. Peabody & Sherman,92,6.8,52421,-33493570
6314,0,Animation,857522,Song of the Sea,93,8.1,35135,857522
6315,28000000,Action,20285518,Fortaleza prohibida,90,5.7,34795,-7714482
6316,6000000,Crime,3319109,Veronica Mars,107,6.8,44057,-2680891
6317,0,Drama,3593460,Calvary,102,7.4,47249,3593460
6318,28000000,Comedy,66954149,"Alexander and the Terrible, Horrible, No Good, Very Bad Day",81,6.2,33226,38954149
6319,22500000,Drama,4190530,Promesa de Vida,111,7.1,60858,-18309470
6320,15000000,Action,24984868,The November Man,108,6.3,54875,9984868
6321,0,Drama,316842,Good Kill,102,6.4,18732,316842
6322,2000000,Drama,43282,Lost River,95,5.8,13654,-1956718
6323,42000000,Animation,64251541,Locos por las nueces,85,5.8,21922,22251541
6324,17000000,Crime,106869,Escobar,120,6.6,16839,-16893131
6325,0,Action,1268760,'71,99,7.2,40959,1268760
6326,0,Drama,33518,Una Señal En La Tormenta,91,6.4,23303,33518
6327,5000000,Drama,17382982,Addicted,106,5.2,6772,12382982
6328,103000000,Animation,131538435,Rio 2,101,6.3,64550,28538435
6329,40000000,Biography,47034272,Jersey Boys,134,6.8,27637,7034272
6330,6000000,Comedy,3588432,Wish I Was Here,106,6.7,32275,-2411568
6331,0,Comedy,4404154,Dear White People,108,6.2,22518,4404154
6332,20000000,Comedy,84525432,Tammy,97,4.9,40108,64525432
6333,0,Drama,1811138,Las nubes de María,124,6.7,21703,1811138
6334,500000,Comedy,2783970,Saving Christmas,79,1.5,13059,2283970
6335,0,Comedy,137945,The Last Five Years,94,5.9,7557,137945
6336,25000000,Action,134938200,Ride Along,99,6.2,84906,109938200
6337,0,Drama,1436243,"Two Days, One Night",95,7.4,37159,1436243
6338,5000000,Comedy,440338,Laggies,99,6.4,34852,-4559662
6339,60000000,Animation,50837305,The Boxtrolls,96,6.8,46486,-9162695
6340,2400000,Comedy,80315,Life After Beth,89,5.6,15603,-2319685
6341,7000000,Drama,14618727,Beyond the Lights,116,6.9,12718,7618727
6342,0,Comedy,18238,The Little Death,96,7.1,21390,18238
6343,0,Action,23840,Kill Me Three Times,90,5.9,16116,23840
6344,12000000,Comedy,25277561,Top Five,102,6.4,23426,13277561
6345,0,Comedy,8129,Just Before I Go,95,6.4,15177,8129
6346,0,Crime,414623,Cold in July,109,6.8,28879,414623
6347,20000000,Drama,2716989,Una buena mentira,110,7.4,22783,-17283011
6348,0,Comedy,48949,Spring,109,6.7,17373,48949
6349,25000000,Biography,36447959,Million Dollar Arm,124,7.0,38459,11447959
6350,1000000,Drama,9837,Camp X-Ray,117,7.0,33542,-990163
6351,0,Action,16909,Big Game,90,5.4,24225,16909
6352,18000000,Comedy,15155772,And So It Goes,94,5.8,10327,-2844228
6353,0,Crime,48817,The Bag Man,108,5.3,14377,48817
6354,0,Comedy,49284,In Order of Disappearance,116,7.2,15045,49284
6355,8500000,Action,1109199,The Rover,103,6.4,36879,-7390801
6356,5000000,Comedy,10429707,Moms' Night Out,98,5.4,11445,5429707
6357,0,Drama,27166,The Keeping Room,95,6.0,4650,27166
6358,24000000,Comedy,65182182,Think Like a Man Too,106,5.8,16706,41182182
6359,12500000,Comedy,48637684,About Last Night,100,6.1,18519,36137684
6360,1000000,Drama,32630,The Duke of Burgundy,104,6.6,8925,-967370
6361,5000000,Biography,5565,Kid Cannabis,110,6.4,8218,-4994435
6362,15000000,Drama,26496583,The Woman in Black 2: Angel of Death,98,4.9,22255,11496583
6363,5000000,Comedy,37440,Rudderless,105,7.5,14913,-4962560
6364,50000000,Adventure,51183113,Muppets Most Wanted,107,6.4,26380,1183113
6365,13000000,Adventure,38916903,Earth to Echo,91,5.8,16757,25916903
6366,0,Adventure,10230,Trash,114,7.2,16903,10230
6367,13200000,Crime,52543632,No Good Deed,84,5.6,14236,39343632
6368,15000000,Drama,30127963,When the Game Stands Tall,115,6.7,13653,15127963
6369,0,Crime,150564,The Tribe,126,7.1,8036,150564
6370,4000000,Horror,9134,13 Sins,93,6.3,26332,-3990866
6371,12000000,Biography,91443253,Heaven Is for Real,99,5.8,22482,79443253
6372,0,Animation,765127,El recuerdo de Marnie,103,7.8,18970,765127
6373,5000000,Comedy,72273,Better Living Through Chemistry,91,6.3,12284,-4927727
6374,4000000,Comedy,17329486,A Haunted House 2,86,4.7,16194,13329486
6375,6000000,Comedy,11766,Barefoot,90,6.6,19248,-5988234
6376,3000000,Drama,585640,The Disappearance of Eleanor Rigby: Them,123,6.3,9569,-2414360
6377,200000,Horror,8496112,The Quiet Ones,98,5.1,16654,8296112
6378,1000000,Crime,104401,God's Pocket,88,6.1,9072,-895599
6379,0,Comedy,13093,A Long Way Down,96,6.4,27014,13093
6380,245000000,Action,936662225,Star Wars: The Force Awakens,136,8.1,687192,691662225
6381,150000000,Action,153636354,Mad Max: Fury Road,120,8.1,661575,3636354
6382,44000000,Crime,54117416,The Hateful Eight,167,7.8,360020,10117416
6383,110000000,Action,155190832,San Andreas,114,6.1,167250,45190832
6384,30000000,Action,46889293,Sicario,121,7.6,257207,16889293
6385,40000000,Drama,166167230,Fifty Shades of Grey,125,4.1,250086,126167230
6386,155000000,Action,89760956,Terminator Genisys,126,6.5,212532,-65239044
6387,135000000,Adventure,183637894,Revenant: El Renacido,156,8.0,522384,48637894
6388,108000000,Adventure,228433663,The Martian,144,8.0,579946,120433663
6389,61000000,Action,81670090,Maze Runner: The Scorch Trials,131,6.3,166404,20670090
6390,245000000,Action,200074175,Spectre,148,6.8,318152,-44925825
6391,150000000,Action,652270625,Jurassic World,124,7.0,469200,502270625
6392,3500000,Horror,25138292,The Witch,92,6.8,111384,21638292
6393,13000000,Drama,14677654,La habitación,118,8.2,241695,1677654
6394,95000000,Drama,201151353,Cinderella,105,7.0,121576,106151353
6395,28000000,Biography,70259870,The Big Short,130,7.8,260244,42259870
6396,30000000,Biography,1872994,Legend,132,7.0,115765,-28127006
6397,65000000,Action,110825712,Spy,119,7.0,193925,45825712
6398,250000000,Action,459005868,Avengers: Age of Ultron,141,7.4,537832,209005868
6399,190000000,Action,93436322,Tomorrowland,130,6.5,147385,-96563678
6400,75000000,Action,45445109,The Man from U.N.C.L.E.,116,7.3,212440,-29554891
6401,15000000,Biography,12706393,The Danish Girl,119,7.1,117432,-2293607
6402,175000000,Animation,356461711,Inside Out,95,8.2,439792,181461711
6403,176000000,Action,47387723,Jupiter Ascending,127,5.3,153531,-128612277
6404,2500000,Drama,36336,Knock Knock,99,4.9,56938,-2463664
6405,20000000,Crime,45055776,Spotlight,128,8.1,287421,25055776
6406,11800000,Drama,12711491,Carol,118,7.2,81966,911491
6407,150000000,Action,195042377,Misión: imposible 5 - Nación secreta,131,7.4,265527,45042377
6408,190000000,Action,353007020,Furious 7,137,7.2,309837,163007020
6409,0,Comedy,8699235,La langosta,119,7.1,131840,8699235
6410,29000000,Comedy,184296230,Pitch Perfect 2,115,6.4,112447,155296230
6411,20000000,Comedy,13650738,Burnt,101,6.6,80803,-6349262
6412,55000000,Action,43482270,Everest,121,7.1,160640,-11517730
6413,130000000,Action,180202163,Ant-Man,117,7.3,388417,50202163
6414,28000000,Biography,161197785,Straight Outta Compton,147,7.9,146861,133197785
6415,160000000,Action,281723902,The Hunger Games: Mockingjay - Part 2,137,6.6,212989,121723902
6416,5000000,Horror,65206105,The Visit,94,6.2,86781,60206105
6417,25000000,Drama,42478175,The Age of Adaline,112,7.2,118727,17478175
6418,53000000,Biography,62575678,Black Mass,123,6.9,140407,9575678
6419,55000000,Drama,31056945,Crimson Peak,119,6.5,102529,-23943055
6420,30000000,Drama,52421953,Revancha,124,7.4,176502,22421953
6421,0,Drama,231703,The Invitation,100,6.7,46822,231703
6422,0,Comedy,2021399,The Dressmaker,119,7.1,36647,2021399
6423,35000000,Drama,109767581,Creed,133,7.6,182827,74767581
6424,110000000,Action,130179072,Insurgent,119,6.3,178165,20179072
6425,35000000,Action,22464430,Hitman: Agent 47,96,5.7,72970,-12535570
6426,8500000,Comedy,34017854,The DUFF,101,6.5,60469,25517854
6427,35000000,Comedy,110212700,Esta chica es un desastre,125,6.3,110244,75212700
6428,5000000,Drama,43771291,The Gift,108,7.1,103554,38771291
6429,105000000,Action,28782481,Punto de quiebre,114,5.3,46887,-76217519
6430,80000000,Animation,169700110,Hotel Transylvania 2,89,6.7,73328,89700110
6431,50000000,Comedy,150357137,Daddy's Home,96,6.1,72842,100357137
6432,0,Biography,643557,The Stanford Prison Experiment,122,6.9,23757,643557
6433,40000000,Drama,72313754,Bridge of Spies,142,7.6,227862,32313754
6434,30000000,Biography,17750583,Steve Jobs,122,7.2,121579,-12249417
6435,31000000,Adventure,58884188,Vacation,99,6.1,77487,27884188
6436,90000000,Action,27367660,The Last Witch Hunter,106,6.0,74795,-62632340
6437,120000000,Action,56117548,Fantastic Four,100,4.3,125934,-63882452
6438,50100000,Comedy,53862963,Focus,105,6.6,171771,3762963
6439,35000000,Comedy,75764672,The Intern,121,7.1,166416,40764672
6440,49000000,Action,31569268,Chappie,120,6.9,194639,-17430732
6441,11000000,Drama,38317535,Brooklyn,117,7.5,99195,27317535
6442,74000000,Animation,336045770,Minions,91,6.4,169228,262045770
6443,37000000,Comedy,20991497,Aloha,105,5.4,46828,-16008503
6444,10000000,Comedy,1978592,Demolition,101,7.0,64109,-8021408
6445,14800000,Comedy,66013057,Magic Mike XXL,115,5.6,44006,51213057
6446,5000000,Crime,3219029,Green Room,95,7.0,69349,-1780971
6447,34000000,Drama,37432299,The Longest Ride,123,7.1,61182,3432299
6448,100000000,Action,25020758,In the Heart of the Sea,122,6.9,94603,-74979242
6449,60000000,Biography,56451232,Joy,124,6.6,102242,-3548768
6450,88000000,Action,78747585,Pixels,105,5.6,106004,-9252415
6451,12000000,Drama,32000304,Paper Towns,109,6.3,76635,20000304
6452,35000000,Biography,34531832,Concussion,123,7.1,64629,-468168
6453,40000000,Comedy,90411453,Get Hard,100,6.0,98662,50411453
6454,68000000,Comedy,81476385,Ted 2,115,6.3,143077,13476385
6455,2000000,Drama,1477002,The Diary of a Teenage Girl,102,6.9,22916,-522998
6456,58000000,Adventure,80080379,Goosebumps,103,6.3,59906,22080379
6457,2000000,Action,9244565,Hardcore: Misión extrema,96,6.7,65051,7244565
6458,0,Comedy,2698509,Youth,124,7.3,55177,2698509
6459,15000000,Action,3635292,Scouts Guide to the Zombie Apocalypse,93,6.3,33629,-11364708
6460,50000000,Crime,1206135,Crimenes ocultos,137,6.5,50379,-48793865
6461,150000000,Adventure,35088320,Pan,111,5.8,49650,-114911680
6462,15000000,Drama,1108247,Macbeth,113,6.7,43481,-13891753
6463,0,Drama,558402,Knight of Cups,118,5.7,18771,558402
6464,10000000,Horror,52218558,La noche del demonio: Capitulo 3,97,6.1,67298,42218558
6465,0,Drama,434640,Bajo la arena,100,7.8,17582,434640
6466,16200000,Action,27285953,No Escape,103,6.8,61262,11085953
6467,26000000,Action,12276810,Self/less,117,6.5,70564,-13723190
6468,8000000,Action,25369,Mr. Right,95,6.3,33496,-7974631
6469,0,Comedy,814775,Sleeping with Other People,101,6.5,29326,814775
6470,0,Comedy,3358518,Un hombre gruñón,116,7.7,25808,3358518
6471,19500000,Crime,20180155,Secret in Their Eyes,111,6.2,29254,680155
6472,25000000,Adventure,43035725,The Night Before,101,6.4,45947,18035725
6473,200000000,Animation,123087120,The Good Dinosaur,93,6.7,80711,-76912880
6474,0,Crime,54734,Regression,106,5.7,28090,54734
6475,135000000,Animation,177397510,Home,94,6.7,79374,42397510
6476,35000000,Adventure,10137502,The Walk,123,7.3,97203,-24862498
6477,40000000,Drama,5775076,Victor Frankenstein,110,6.0,40525,-34224924
6478,0,Horror,19980,The Blackcoat's Daughter,93,5.8,6768,19980
6479,15000000,Comedy,42592530,Krampus,98,6.2,44393,27592530
6480,8000000,Comedy,6743776,Me and Earl and the Dying Girl,105,7.8,96689,-1256224
6481,0,Drama,343139,High-Rise,119,5.7,28067,343139
6482,25000000,Action,1512815,Jane Got a Gun,98,5.9,15689,-23487185
6483,25000000,Action,16027866,El transportador recargado,96,5.1,32420,-8972134
6484,30000000,Comedy,32361416,Entourage,104,6.6,66336,2361416
6485,7000000,Comedy,17474107,Dope,103,7.3,69552,10474107
6486,50000000,Action,26442251,Run All Night,114,6.6,85225,-23557749
6487,0,Crime,4715819,True Story,99,6.3,44237,4715819
6488,0,Drama,1982505,A Bigger Splash,125,6.4,16900,1982505
6489,0,Drama,12229314,Far from the Madding Crowd,119,7.1,36196,12229314
6490,10000000,Drama,531009,Frente al mar,122,5.2,13055,-9468991
6491,13000000,Drama,18700837,Eye in the Sky,102,7.3,61722,5700837
6492,16000000,Drama,32095,Equals,101,6.0,18681,-15967905
6493,23000000,Comedy,64460211,The Wedding Ringer,101,6.7,60737,41460211
6494,0,Biography,3866794,The Man Who Knew Infinity,108,7.2,33630,3866794
6495,2000000,Drama,3590010,We Are Your Friends,96,6.2,27695,1590010
6496,6000000,Drama,83861,Beasts of No Nation,137,7.8,52905,-5916139
6497,30000000,Comedy,87044645,Sisters,118,6.0,52137,57044645
6498,0,Drama,80809,Tale of Tales,134,6.4,18674,80809
6499,28000000,Action,14434604,American Ultra,100,6.1,67391,-13565396
6500,11000000,Biography,33305037,Woman in Gold,109,7.3,42052,22305037
6501,0,Drama,6438,Into the Forest,101,5.9,11816,6438
6502,8000000,Animation,3442820,Anomalisa,90,7.2,47499,-4557180
6503,12000000,Sci-Fi,22331028,Project Almanac,106,6.4,65169,10331028
6504,11000000,Comedy,4027764,Irrational Man,95,6.6,42507,-6972236
6505,40000000,Action,10640645,The Gunman,115,5.8,32345,-29359355
6506,4000000,Mystery,35385560,The Boy Next Door,91,4.7,31057,31385560
6507,0,Action,176637,La última ola,105,6.7,20509,176637
6508,60000000,Action,7605668,Mortdecai,107,5.5,54191,-52394332
6509,15000000,Biography,7857741,Trumbo,124,7.5,60593,-7142259
6510,10000000,Horror,27736779,Sinister 2,97,5.3,33723,17736779
6511,81200000,Animation,1339152,El principito,108,7.8,41751,-79860848
6512,3500000,Comedy,615654,The Bronze,100,6.0,7520,-2884346
6513,35000000,Horror,47425125,Poltergeist,93,4.9,47376,12425125
6514,8000000,Adventure,29467855,A Walk in the Woods,104,6.3,18661,21467855
6515,26000000,Biography,12188642,Los 33,127,6.9,27925,-13811358
6516,74000000,Animation,162994032,The SpongeBob Movie: Sponge Out of Water,92,6.0,38659,88994032
6517,25000000,Drama,20083,The Sea of Trees,110,5.9,8519,-24979917
6518,100000,Comedy,701837,Tangerine,88,7.0,16597,601837
6519,70000000,Crime,7097125,Blackhat,133,5.4,44249,-62902875
6520,0,Biography,667476,Born to Be Blue,97,6.9,5113,667476
6521,90000000,Animation,85886987,Alvin and the Chipmunks: The Road Chip,100,5.1,12069,-4113013
6522,8000000,Thriller,16458,Blackway,90,5.2,4931,-7983542
6523,0,Comedy,1100000,The Overnight,79,6.1,12642,1100000
6524,1000000,Comedy,14443077,"Hello, My Name Is Doris",90,6.7,14007,13443077
6525,35000000,Action,34507079,Hot Pursuit,87,5.1,40431,-492921
6526,28000000,Comedy,6998324,Our Brand Is Crisis,107,6.1,16204,-21001676
6527,8500000,Drama,187112,Maggie,95,5.6,35167,-8312888
6528,3000000,Drama,67790117,War Room,120,6.4,10268,64790117
6529,9600000,Biography,2541554,Conspiración y poder,125,6.8,14615,-7058446
6530,9400000,Crime,739478,Drishyam,163,8.4,42547,-8660522
6531,0,Comedy,2461121,Mistress America,84,6.7,19140,2461121
6532,0,Drama,118483,Z for Zachariah,98,6.0,21852,118483
6533,0,Comedy,45650,Girl Asleep,77,6.2,1693,45650
6534,18000000,Comedy,26822144,Ricki and the Flash,101,6.0,18428,8822144
6535,5000000,Adventure,2184640,Jem and the Holograms,118,4.1,5640,-2815360
6536,14000000,Biography,4693356,Suffragette,106,6.9,28377,-9306644
6537,20000000,Adventure,42652003,Max,111,6.8,22181,22652003
6538,0,Drama,637555,Remember,94,7.4,14266,637555
6539,18026148,Action,6738000,Baahubali: The Beginning,159,8.2,81329,-11288148
6540,3300000,Horror,25799043,The Lazarus Effect,83,5.2,32659,22499043
6541,0,Comedy,3351230,Maggie's Plan,98,6.2,10929,3351230
6542,0,Comedy,98818,The Lure,92,6.3,2000,98818
6543,0,Action,50000,Turbo Kid,93,6.7,20452,50000
6544,17000000,Biography,44469602,"McFarland, USA",129,7.4,27814,27469602
6545,0,Drama,143656,Manifesto,95,7.2,1314,143656
6546,65000000,Action,74068,Dragon Blade,127,6.1,14229,-64925932
6547,0,Drama,140779,Krisha,83,7.1,4086,140779
6548,10000000,Drama,17737646,Mr. Holmes,104,6.9,51307,7737646
6549,0,Drama,5249,The Girl in the Book,86,6.2,3075,5249
6550,3000000,Drama,1828933,Desierto,88,6.0,6253,-1171067
6551,17000000,Comedy,26284475,Love the Coopers,107,5.7,13475,9284475
6552,0,Comedy,2254,Jenny's Wedding,94,5.5,7852,2254
6553,99000000,Animation,130178411,The Peanuts Movie,88,7.1,34889,31178411
6554,36000000,Action,2679437,Ip Man 3,105,7.1,31713,-33320563
6555,0,Drama,4267,Synchronicity,101,5.5,7562,4267
6556,10000000,Comedy,5348317,Danny Collins,106,7.0,24666,-4651683
6557,12000000,Drama,57017904,The Perfect Guy,100,5.6,7922,45017904
6558,0,Drama,845464,Mustang: belleza salvaje,97,7.7,25260,845464
6559,0,Animation,12427046,Strange Magic,99,5.8,8009,12427046
6560,0,Comedy,240067,The Family Fang,105,6.1,5585,240067
6561,0,Drama,1777043,El hijo de Saúl,107,7.5,32339,1777043
6562,13000000,Biography,1646468,I Saw the Light,123,5.7,4460,-11353532
6563,0,Comedy,1162653,Miss You Already,112,6.8,12743,1162653
6564,5000000,Drama,66371,3 Generations,92,5.6,2608,-4933629
6565,10000000,Drama,17472,Strangerland,112,5.2,6735,-9982528
6566,0,Horror,8967,The Hallow,97,5.7,11545,8967
6567,0,Drama,26376,The Daughter,96,6.7,3194,26376
6568,30000000,Action,71038190,Paul Blart: Mall Cop 2,94,4.4,27268,41038190
6569,6000000,Biography,10017675,The Lady in the Van,104,6.7,18091,4017675
6570,0,Comedy,89182,El nuevo nuevo testamento,114,7.1,20984,89182
6571,14000000,Comedy,12282677,Hot Tub Time Machine 2,93,5.1,31612,-1717323
6572,10000000,Horror,18300124,Paranormal Activity: The Ghost Dimension,88,4.6,19280,8300124
6573,0,Comedy,2647377,Chi-Raq,127,5.7,6983,2647377
6574,0,Comedy,129747,Mississippi Grind,108,6.3,13207,129747
6575,10000000,Comedy,33078266,The Second Best Exotic Marigold Hotel,122,6.6,25886,23078266
6576,0,Comedy,208799,Una sonrisa a la vida,108,7.3,7973,208799
6577,35000000,Comedy,10214013,Unfinished Business,91,5.4,26051,-24785987
6578,7000000,Biography,532988,Freeheld,103,6.5,8801,-6467012
6579,2000000,Action,2557668,Captive,97,5.4,5253,557668
6580,0,Biography,2993669,The End of the Tour,106,7.3,22192,2993669
6581,3000000,Comedy,660994,The D Train,101,5.0,9146,-2339006
6582,0,Biography,155075,Experimenter,98,6.6,13263,155075
6583,2000000,Western,229094,Slow West,84,6.9,33032,-1770906
6584,0,Drama,41866,Closet Monster,90,7.0,4860,41866
6585,0,Action,449523,Attack on Titan: Part 1,98,5.1,9847,449523
6586,11000000,Drama,161789,Más fuerte que las bombas,109,6.6,8742,-10838211
6587,800000,Crime,128002,Cop Car,88,6.3,24256,-671998
6588,1400000,Adventure,1329249,Embrace of the Serpent,125,7.9,13698,-70751
6589,0,Drama,4250507,45 Years,91,7.1,23800,4250507
6590,4000000,Biography,569381,Una historia de amor y oscuridad,95,6.0,2003,-3430619
6591,25000000,Animation,19375982,Shaun the Sheep Movie,85,7.4,28138,-5624018
6592,3200000,Comedy,4265673,The Meddler,103,6.3,7979,1065673
6593,15000000,Comedy,2982281,Rock the Kasbah,106,5.5,8063,-12017719
6594,15000000,Action,613556,The Assassin,105,6.4,12237,-14386444
6595,20000000,Drama,6420319,El gran pequeño,106,7.4,19156,-13579681
6596,0,Comedy,7425963,I'll See You in My Dreams,92,6.7,5282,7425963
6597,8000000,Horror,1712111,The Vatican Tapes,91,5.1,13305,-6287889
6598,5000000,Drama,4700361,90 Minutes in Heaven,121,4.7,2631,-299639
6599,0,Drama,35034,Summertime,105,6.6,2301,35034
6600,6000000,Drama,177680,The Bad Batch,118,5.4,8340,-5822320
6601,125000000,Action,54645723,Assassin's Creed,115,5.9,133338,-70354277
6602,30000000,Comedy,151101803,La La Land,128,8.2,308891,121101803
6603,175000000,Action,325100054,Suicide Squad,123,6.2,435667,150100054
6604,75000000,Animation,270329045,Sing,108,7.1,81466,195329045
6605,180000000,Adventure,234037575,Fantastic Beasts and Where to Find Them,133,7.4,268073,54037575
6606,150000000,Animation,248757044,Moana,107,7.6,157290,98757044
6607,90000000,Action,93381044,The Magnificent Seven,132,6.9,138262,3381044
6608,44000000,Action,86198014,The Accountant,128,7.4,188598,42198014
6609,30000000,Adventure,8574339,The Lost City of Z,141,6.6,39409,-21425661
6610,22500000,Crime,10639114,Nocturnal Animals,116,7.5,152436,-11860886
6611,25000000,Biography,169380936,Hidden Figures,127,7.8,121818,144380936
6612,47000000,Drama,100546139,Arrival,116,8.0,391385,53546139
6613,125000000,Animation,153707064,Trolls,92,6.5,49423,28707064
6614,200000000,Action,532177324,Rogue One,133,7.9,365473,332177324
6615,40000000,Biography,67115062,Hasta el último hombre,139,8.2,263728,27115062
6616,58000000,Action,363070709,Deadpool,108,8.0,668625,305070709
6617,9000000,Horror,138141585,Split,117,7.3,213536,129141585
6618,110000000,Adventure,100014699,Passengers,116,7.0,237553,-9985301
6619,250000000,Action,330360194,Batman v Superman: Dawn of Justice,151,6.6,497351,80360194
6620,185000000,Action,158848340,Star Trek Beyond,122,7.1,179426,-26151660
6621,0,Animation,5017246,Your name,106,8.5,54503,5017246
6622,165000000,Action,232641920,Doctor Strange,115,7.5,348307,67641920
6623,12000000,Biography,51694854,Lion,118,8.1,133709,39694854
6624,250000000,Action,408084349,Captain America: Civil War,147,7.9,442645,158084349
6625,40000000,Horror,102470008,The Conjuring 2,134,7.4,151427,62470008
6626,20000000,Drama,56245075,Me Before You,106,7.4,127889,36245075
6627,45000000,Crime,75311445,The Girl on the Train,112,6.5,116916,30311445
6628,178000000,Action,155442489,X-Men: Apocalypse,144,7.0,296415,-22557511
6629,8500000,Drama,47695120,Manchester by the Sea,137,7.9,159673,39195120
6630,150000000,Animation,341268248,Zootopia,108,8.0,317549,191268248
6631,85000000,Action,40069087,Allied,124,7.1,94624,-44930913
6632,40000000,Action,26830068,Resident Evil: The Final Chapter,107,5.6,58140,-13169932
6633,1500000,Drama,27850912,Moonlight,111,7.5,161857,26350912
6634,9900000,Crime,89210468,Don't Breathe,88,7.2,139449,79310468
6635,12000000,Crime,26862450,Hell or High Water,102,7.6,132328,14862450
6636,110000000,Action,66002193,Allegiant,120,5.7,76550,-43997807
6637,110000000,Adventure,87242834,Miss Peregrine's Home for Peculiar Children,127,6.7,116495,-22757166
6638,46000000,Adventure,7079191,Silence,161,7.2,61798,-38920809
6639,120000000,Action,162434410,Jason Bourne,123,6.7,163614,42434410
6640,9000000,Comedy,14260193,The Edge of Seventeen,104,7.4,59867,5260193
6641,25000000,Biography,12785093,The Founder,100,7.2,62193,-12214907
6642,180000000,Action,126643061,The Legend of Tarzan,110,6.3,128712,-53356939
6643,35000000,Action,30348260,Underworld: Blood Wars,91,5.8,49911,-4651740
6644,20000000,Adventure,7222964,Gold,120,6.7,32147,-12777036
6645,0,Drama,508425,Voraz,99,7.0,22618,508425
6646,50000000,Comedy,36261763,The Nice Guys,116,7.4,193151,-13738237
6647,43000000,Drama,3730982,A Monster Calls,108,7.5,49969,-39269018
6648,0,Crime,2005473,The Handmaiden,144,8.1,43552,2005473
6649,60000000,Biography,125070033,Sully,96,7.5,157212,65070033
6650,20000000,Comedy,113257297,Bad Moms,100,6.2,76251,93257297
6651,30000000,Animation,12760985,Leap!,89,6.8,9517,-17239015
6652,40000000,Drama,8106986,A Cure for Wellness,146,6.4,45187,-31893014
6653,150000000,Action,45157105,The Great Wall,103,6.0,82181,-104842895
6654,40000000,Comedy,43017433,War Dogs,114,7.1,123020,3017433
6655,38000000,Comedy,60269575,Why Him?,111,6.3,63612,22269575
6656,9000000,Biography,13958679,Jackie,100,6.8,50652,4958679
6657,108000000,Action,10377558,Live by Night,129,6.4,35064,-97622442
6658,75000000,Animation,368384330,La vida secreta de tus mascotas,87,6.6,133755,293384330
6659,140000000,Action,31153464,Gods of Egypt,127,5.4,78473,-108846536
6660,40000000,Action,14896798,Keeping Up with the Joneses,105,5.8,39443,-25103202
6661,60000000,Action,58399160,Jack Reacher: Sin regreso,118,6.1,91071,-1600840
6662,0,Action,3021345,Ella es un monstruo,109,6.2,29178,3021345
6663,19000000,Animation,97661826,Sausage Party,89,6.2,133200,78661826
6664,50000000,Action,52853219,13 Hours,144,7.3,82656,2853219
6665,36000000,Drama,30982955,Collateral Beauty,97,6.8,56439,-5017045
6666,0,Comedy,5875006,Captain Fantastic,118,7.9,121560,5875006
6667,75000000,Action,34343574,Inferno,121,6.2,111448,-40656426
6668,5000000,Comedy,5300675,Paris Can Wait,92,5.8,2629,300675
6669,13000000,Drama,3439171,Sola contra el poder,132,7.4,28302,-9560829
6670,144000000,Action,128344089,Ghostbusters,116,5.3,157351,-15655911
6671,15000000,Drama,71897215,10 Cloverfield Lane,104,7.2,208655,56897215
6672,20000000,Adventure,38562379,Nerve,96,6.6,81127,18562379
6673,160000000,Action,47365290,Warcraft: The Beginning,123,6.9,197373,-112634710
6674,33000000,Adventure,46007113,Mike and Dave Need Wedding Dates,98,6.0,61076,13007113
6675,90000000,Action,65075540,Los ilusionistas 2,129,6.5,171985,-24924460
6676,175000000,Adventure,364001123,The Jungle Book,106,7.5,209062,189001123
6677,7000000,Horror,1333124,El demonio neón,118,6.2,56660,-5666876
6678,110000000,Action,61284947,Horizonte profundo,107,7.2,104498,-48715053
6679,17000000,Drama,55121623,The Shallows,86,6.3,87057,38121623
6680,24000000,Drama,57642961,Fences,139,7.2,62351,33642961
6681,23000000,Biography,15785632,Eddie the Eagle,106,7.4,60644,-7214368
6682,5000000,Action,10164675,The Belko Experiment,89,6.1,23422,5164675
6683,45000000,Crime,31886361,Día del atentado,133,7.4,51563,-13113639
6684,4900000,Horror,67235683,Lights Out,81,6.4,80019,62335683
6685,40000000,Biography,21587519,Snowden,134,7.3,92094,-18412481
6686,0,Drama,1032942,Certain Women,107,6.5,6298,1032942
6687,200000000,Animation,486295561,Finding Dory,97,7.4,173005,286295561
6688,115000000,Action,47952020,The Huntsman: Winter's War,114,6.1,71570,-67047980
6689,10000000,Action,1798472,Free Fire,91,6.5,22157,-8201528
6690,0,Drama,606989,The Exception,107,6.8,3985,606989
6691,20000000,Drama,12545979,The Light Between Oceans,133,7.2,32595,-7454021
6692,165000000,Action,103144286,Independence Day: Resurgence,120,5.3,137119,-61855714
6693,50000000,Action,127440871,Central Intelligence,107,6.3,106773,77440871
6694,8000000,Action,3912052,Morgan,92,5.8,27297,-4087948
6695,28000000,Action,10907291,Pride and Prejudice and Zombies,108,5.8,37491,-17092709
6696,100000000,Action,26384681,Ben-Hur,123,5.7,31863,-73615319
6697,31500000,Action,14268533,Criminal,113,6.3,42478,-17231467
6698,0,Comedy,19025,Carrie Pilby,98,6.6,2617,19025
6699,28000000,Biography,15425870,The Infiltrator,127,7.0,50194,-12574130
6700,0,Action,2129768,Estación Zombie: tren a Busan,118,7.5,72896,2129768
6701,27500000,Comedy,35537564,Dirty Grandpa,102,6.0,82289,8037564
6702,70000000,Animation,72655779,Storks,87,6.8,40740,2655779
6703,0,Comedy,3595841,Their Finest,117,6.8,8538,3595841
6704,6000000,Drama,1305195,Personal Shopper,105,6.2,16843,-4694805
6705,25000000,Action,17356894,Masterminds,95,5.8,34656,-7643106
6706,0,Drama,1007759,Lady Macbeth,89,7.0,6087,1007759
6707,3000000,Adventure,4208879,Swiss Army Man,97,7.0,69827,1208879
6708,38000000,Action,34912982,The 5th Wave,112,5.2,76535,-3087018
6709,0,Drama,18709066,The Choice,111,6.6,22972,18709066
6710,135000000,Action,82051601,Teenage Mutant Ninja Turtles: Out of the Shadows,112,6.0,64684,-52948399
6711,60000000,Action,62524260,London Has Fallen,99,5.9,106352,2524260
6712,9000000,Horror,34904885,Ouija: Origin of Evil,99,6.1,35690,25904885
6713,0,Action,12391761,Dangal,161,8.7,70565,12391761
6714,35000000,Comedy,55291815,Neighbors 2: Sorority Rising,92,5.7,83340,20291815
6715,60000000,Animation,48023088,Kubo and the Two Strings,101,7.8,82575,-11976912
6716,35000000,Comedy,24252420,El bebé de Bridget Jones,118,6.6,48197,-10747580
6717,20000000,Action,12626905,Triple 9,115,6.3,51631,-7373095
6718,22000000,Comedy,30080225,"Hail, Caesar!",106,6.3,94361,8080225
6719,8000000,Horror,35794166,The Boy,97,6.0,55856,27794166
6720,6000000,Biography,4847865,Bleed for This,117,6.8,15158,-1152135
6721,30000000,Comedy,11103205,Café Society,96,6.7,50826,-18896795
6722,170000000,Adventure,77042381,Alice Through the Looking Glass,113,6.2,62895,-92957619
6723,29000000,Biography,27370107,Florence Foster Jenkins,111,6.9,35671,-1629893
6724,18000000,Drama,3707794,Midnight Special,112,6.7,58549,-14292206
6725,0,Comedy,2141423,Paterson,118,7.4,36369,2141423
6726,10000000,Action,79003080,The Purge: Election Year,108,6.0,60239,69003080
6727,0,Comedy,3233839,Sing street; este es tu momento,106,8.0,58989,3233839
6728,35000000,Action,6864016,The Brothers Grimsby,83,6.2,67444,-28135984
6729,0,Adventure,5202582,Hunt for the Wilderpeople,101,7.9,60530,5202582
6730,105000000,Animation,64063008,Ice Age: Collision Course,94,5.7,38556,-40936992
6731,0,Comedy,1478960,Toni Erdmann,162,7.5,29072,1478960
6732,50000000,Comedy,28848693,Zoolander 2,101,4.7,51053,-21151307
6733,0,Adventure,662786,American Honey,163,7.0,23250,662786
6734,10000000,Comedy,3369431,Everybody Wants Some!!,117,7.0,39909,-6630569
6735,40000000,Action,21203260,El especialista: La resurrección,98,5.6,53849,-18796740
6736,125000000,Action,33370166,Monster Trucks,104,5.7,9244,-91629834
6737,0,Biography,320725,Chuck,98,6.5,1896,320725
6738,45000000,Comedy,54730514,Office Christmas Party,105,5.8,37358,9730514
6739,7000000,Comedy,5663855,20th Century Women,119,7.4,20814,-1336145
6740,140000000,Adventure,55483770,The BFG,117,6.4,56297,-84516230
6741,80000000,Action,27550735,The Finest Hours,117,6.8,47688,-52449265
6742,20000000,Comedy,9393835,Popstar: Never Stop Never Stopping,87,6.7,35620,-10606165
6743,38000000,Comedy,46813366,How to Be Single,110,6.1,63520,8813366
6744,0,Biography,6139048,Maudie,115,7.7,1735,6139048
6745,10000000,Drama,6883951,Presencia siniestra,91,4.7,7396,-3116049
6746,0,Drama,785405,The Wailing,156,7.5,21562,785405
6747,250000,Action,3847290,Sleight,89,5.9,4012,3597290
6748,0,Drama,3810812,Norman,118,6.3,2716,3810812
6749,0,Horror,150372,The Void,90,5.8,15932,150372
6750,73000000,Animation,107509366,The Angry Birds Movie,97,6.3,59472,34509366
6751,1500000,Horror,779820,31,102,5.0,11945,-720180
6752,15000000,Comedy,1658706,The Comedian,120,5.7,3729,-13341294
6753,40000000,Drama,1721524,Billy Lynn's Long Halftime Walk,113,6.3,14631,-38278476
6754,65000000,Action,76204454,Pete's Dragon,102,6.7,41083,11204454
6755,27000000,Crime,41012075,Money Monster,98,6.5,72997,14012075
6756,50000000,Action,20758378,Free State of Jones,139,6.9,34513,-29241622
6757,0,Drama,259412,Wakefield,106,6.4,6795,259412
6758,0,Biography,2959288,Anthropoid,120,7.2,28589,2959288
6759,25000000,Comedy,32463917,Mother's Day,118,5.6,22504,7463917
6760,25000000,Comedy,3647836,Rules Don't Apply,127,5.7,5192,-21352164
6761,145000000,Animation,143528619,Kung Fu Panda 3,95,7.1,95310,-1471381
6762,0,Horror,8834,Dead Awake,99,4.6,1645,8834
6763,9000000,Biography,7696098,Loving,123,7.0,21231,-1303902
6764,0,Adventure,6155650,Lowriders,98,5.7,980,6155650
6765,0,Crime,541457,El fin del sueño americano,108,6.1,9061,541457
6766,0,Action,1908028,Shin Godzilla,120,6.7,11739,1908028
6767,20000000,Comedy,73159525,Boo! A Madea Halloween,103,4.7,4640,53159525
6768,0,Action,50381,In a Valley of Violence,104,6.0,9141,50381
6769,10000000,Horror,26583369,The Forest,93,4.8,30580,16583369
6770,35000000,Biography,23049575,Whiskey Tango Foxtrot,112,6.6,38907,-11950425
6771,10000000,Action,3771397,Max Steel,92,4.6,13521,-6228603
